about=hakkında 
above=üzerine 
across=karşıya 
action=çalışma 
activity=etkinlik 
actor=oyuncu 
actress=oyuncu 
add=toplamak 
address=hitap etmek 
adult=yetişkin 
advice=nasihat 
afraid=korkmuş 
after=sonra 
afternoon=öğleden sonra 
again=bir daha 
age=yaş 
ago=evvel 
agree=aynı fikirde olmak 
air=havalandırmak 
airport=havalimanı 
all=tüm 
also=ayrıca 
always=hep 
amazing=şaşırtıcı 
and=ile
angry=kızmış 
animal=hayvan 
another=öbür 
answer=yanıt vermek 
any=lalettayin 
anyone=hiç kimse 
anything=hiçbir şey 
apartment=daire 
apple=elma 
April=nisan 
area=alan 
arm=kol 
around=sularında 
arrive=varmak 
art=sanat 
article=bent 
artist=artist 
as=olarak 
ask=soru sormak 
at=üzere 
August=ağustos 
aunt=hala 
autumn=güz 
away=uzak 
baby=yavru 
back=art 
bad=kötü 
bag=poşet 
ball=balo 
banana=muz 
band=bant 
bank=banka 
bath=yıkanmak 
bathroom=tuvalet 
be=bulunmak 
beach=sahil 
beautiful=güzel 
because=çünkü
become=haline gelmek 
bed=yatak 
bedroom=yatak odası 
beer=bira 
before=evvel 
begin=başlatmak 
beginning=başlangıç 
behind=ardındaki 
believe=inanmak 
below=alttaki 
best=en iyi 
better=daha iyi 
between=arasında 
bicycle=bisiklet 
big=iri 
bike=bisiklete binmek 
bill=senet 
bird=kuş 
birthday=yaş günü 
black=siyahi 
blog=web günlüğü
blonde=sarışın 
blue=mavi 
boat=tekne 
body=ceset 
book=ayırtmak 
boot=bot 
bored=sıkılmış 
boring=bıktırıcı 
born=doğan 
both=her ikisi de 
bottle=şişe 
box=kutu 
boy=delikanlı 
boyfriend=flört 
bread=ekmek 
break=kopmak 
breakfast=kahvaltı 
bring=getirmek 
brother=kardeş 
brown=kahverengi 
build=inşa etmek 
building=inşaat 
bus=otobüs 
business=işletme 
busy=işlek 
but=ancak
butter=tereyağı 
buy=ısmarlamak 
by=geçecek biçimde 
bye=ast 
cafe=kafe 
cake=kek 
call=çağırmak 
camera=fotoğraf makinesi 
can=olabilmek 
cannot=edememek 
capital=sermaye 
car=otomobil 
card=kart 
career=kariyer 
carrot=kızıl saç 
carry=taşımak 
cat=kedi 
CD=dış çap
cent=sent 
centre=merkez 
century=asır 
chair=koltuk 
change=değişmek 
chart=çizelge 
cheap=ucuz 
check=denetlemek 
cheese=peynir 
chicken=tavuk 
child=evlat 
chocolate=çikolata 
choose=seçmek 
cinema=sinema 
city=kent 
class=ders 
classroom=sınıf 
clean=temizlemek 
climb=tırmanmak 
clock=saat 
close=kapamak 
clothes=giysi 
club=kulüp 
coat=kaplamak 
coffee=kahve 
cold=soğukluk 
college=yüksekokul 
colour=renk 
come=gelmek 
common=alışılmış 
company=bölük 
compare=mukayese etmek 
complete=tamamlamak 
computer=bilgisayar 
concert=konser 
conversation=konuşma 
cook=yemek pişirmek 
cooking=yemek pişirme 
cool=soğutmak 
correct=düzeltmek 
cost=mal olmak 
could=-abilirdi 
country=yurt 
course=kurs 
cousin=kuzen 
cow=inek 
cream=kaymak 
create=meydana getirmek 
culture=kültür 
cup=kupa 
customer=müşteri 
cut=kesmek 
dad=babacığım 
dance=dans etmek 
dancer=dansöz 
dancing=dans etme 
dangerous=tehlikeli 
dark=karanlık 
date=(biriyle) çıkmak 
daughter=kız çocuk 
day=gün 
dear=sevgili 
December=aralık (ayı) 
decide=karar vermek 
delicious=nefis 
describe=betimlemek 
description=tasvir 
design=dizayn etmek 
desk=çalışma masası 
detail=detay 
dialogue=diyalog 
dictionary=sözlük 
die=ölmek 
diet=diyet 
difference=ayrım 
different=farklı 
difficult=çetin 
dinner=akşam yemeği 
dirty=pisletmek 
discuss=görüşmek 
dish=tabak 
do=etmek 
doctor=doktor 
dog=it 
dollar=amerikan parası 
door=kapı 
down=aşağıya doğru 
downstairs=aşağı katta 
draw=karalamak 
dress=giyinmek 
drink=içmek 
drive=sürmek 
driver=sürücü 
during=zarfında 
DVD=dvd 
each=her biri 
ear=kulak 
early=erken 
east=doğu 
easy=rahat 
eat=yemek yemek 
egg=yumurta 
eight=sekiz 
eighteen=onsekiz 
eighty=seksen 
elephant=fil 
eleven=onbir 
else=başka 
email=email göndermek 
end=sona ermek 
enjoy=tadını çıkarmak 
enough=kafi 
euro=euro 
even=düzgün 
evening=akşam 
event=olay 
ever=durmadan 
every=her 
everybody=cümle alem 
everyone=herkes 
everything=her şey 
exam=imtihan 
example=örnek 
excited=heyecanlı 
exciting=heyecanlı 
exercise=alıştırma yapmak 
expensive=masraflı 
explain=açıklamak 
extra=ekstra 
eye=göz 
face=yüzleşmek 
fact=vaka 
fall=inmek 
FALSE=takma 
family=sülale 
famous=ünlü 
fantastic=fantastik 
far=uzak 
farm=çiftlik 
farmer=çiftçi 
fast=süratli 
fat=semirtmek 
father=papaz 
favourite=gözde 
February=şubat 
feel=hissetmek 
feeling=his 
festival=bayram 
few=az 
fifteen=onbeş 
fifth=beşinci 
fifty=elli sayısı (50) 
fill=doldurmak 
film=film 
final=final 
find=bulmak 
fine=ceza kesmek 
finish=sona ermek 
fire=ateşlemek 
first=birinci 
fish=balık 
five=beş 
flat=düz yüzey 
flight=uçuş 
floor=yeri kaplamak 
flower=çiçek 
fly=uçmak 
follow=takip etmek 
food=besin 
foot=ayak 
football=futbol 
for=için 
forget=unutmak 
form=biçimlendirmek 
forty=kırk sayısı (40) 
four=dört 
fourteen=on dört sayısı 
fourth=dörtte bir 
free=bağımsız 
Friday=cuma 
friend=ahbap 
friendly=arkadaş canlısı 
from=itibaren 
front=yönelmek 
fruit=meyve vermek 
full=tok 
fun=eğlence 
funny=komik 
future=istikbal 
game=oyun 
garden=bahçe 
geography=coğrafya 
get=elde etmek 
girl=kız 
girlfriend=kız arkadaş 
give=vermek 
glass=kadeh 
go=hareket etmek 
good=güzel 
goodbye=güle güle 
grandfather=dede 
grandmother=babaanne 
grandparent=büyükbaba 
great=mükemmel 
green=yeşil 
grey=ağartmak 
group=grup 
grow=yetişmek 
guess=tahmin etmek 
guitar=gitarist 
gym=spor salonu 
hair=tüy 
half=yarım 
hand=el 
happen=meydana gelmek 
happy=sevinçli 
hard=çetin 
hat=şapka 
hate=nefret etmek 
have=sahip olmak 
have to=mecburiyetinde kalmak 
he=eril o 
head=kelle 
health=sıhhat 
healthy=sıhhatli 
hear=duymak 
hello=merhaba 
help=yardım etmek 
her=ona 
here=burada 
hey=selam
hi=merhaba 
high=yüksek 
him=ona 
his=eril onunki 
history=geçmiş 
hobby=hobi 
holiday=bayram 
home=ev 
homework=ödev 
hope=ummak 
horse=beygir 
hospital=hastane 
hot=kızgın 
hotel=otel 
hour=saat 
house=ev 
how=nasıl 
however=bununla birlikte 
hundred=yüz 
hungry=acıkmış 
husband=koca 
I=ben 
Internet=internet 
ice=buz 
ice cream=dondurma 
idea=fikir 
if=eğer
imagine=hayal etmek 
important=mühim 
improve=geliştirmek 
in=içeri 
include=katmak 
information=bilgi 
interest=ilgilendirmek 
interested=alakalı 
interesting=ilginç 
interview=görüşmek 
into=içine 
introduce=tanıtmak 
island=ada 
it=ona 
its=onun 
jacket=ceket 
January=ocak 
jeans=kot 
job=görev 
join=birleştirmek 
journey=yolculuk 
juice=meyve suyu 
July=temmuz 
June=haziran 
just=sadece 
keep=tutmak 
key=anahtar 
kilometre=kilometre 
kind=tür 
kitchen=mutfak 
know=bilmek 
land=karaya ayak basmak 
language=lisan 
large=iri 
last=sonuncu 
late=gecikmiş 
later=sonradan 
laugh=gülmek 
learn=öğrenmek 
leave=bırakmak 
left=sol 
leg=ayak (mobilya/pergel) 
lesson=ders 
let=izin vermek 
letter=mektup 
library=kitaplık 
lie=yatmak 
life=yaşam 
light=aydınlık 
like=beğenmek 
line=astarlamak 
lion=aslan 
list=listelemek 
listen=dinlemek 
little=ufak 
live=yaşamak 
local=lokal 
long=uzun 
look=bakmak 
lose=kaybetmek 
lot=pay 
love=sevmek 
lunch=öğle yemeği 
machine=makine 
magazine=fişek haznesi 
main=esas 
make=yapmak 
man=insan 
many=birçok 
map=harita 
March=yürüyüş yapmak (topluca) 
market=çarşı 
married=evli 
match=eşleştirmek 
May=mayıs ayı 
maybe=belki 
me=ben 
meal=öğün 
mean=demek istemek 
meaning=mana 
meat=et 
meet=karşılaşmak 
meeting=toplantı 
member=üye 
menu=menü 
message=ileti 
metre=metre 
midnight=geceyarısı 
mile=mil 
milk=süt 
million=milyon 
minute=dakika 
miss=ıska geçmek 
mistake=yanılgı 
model=model 
modern=çağdaş 
moment=an 
Monday=pazartesi 
money=para 
month=ay 
more=daha fazla 
morning=sabah 
most=en 
mother=ana 
mountain=dağ 
mouse=fare 
mouth=ağız 
move=kımıldamak 
movie=film (sinemada gösterilen) 
much=fazla 
mum=maske ile oynamak 
museum=müze 
music=müzik 
must=gerekmek 
my=benim 
name=isim 
natural=tabii 
near=yakın 
need=ihtiyaç duymak 
negative=negatif 
neighbour=komşu 
never=hiç 
new=yeni 
news=haber 
newspaper=gazete 
next=sonraki 
next to=bitişik 
nice=sevimli 
night=gece 
nine=dokuz 
nineteen=XIX 
ninety=doksan sayısı (90) 
no=hayır 
no one=hiç kimse 
nobody=hiç kimse 
north=kuzey 
nose=burun 
not=gayri 
note=not etmek 
nothing=hiç 
November=kasım 
now=şimdi 
number=numaralamak 
nurse=hemşirelik yapmak 
object=itiraz etmek 
o'clock=saat 
October=ekim 
of=karşı 
off=kapalı 
office=makam 
often=sık sık 
oh=ey 
OK=onaylamak 
old=eskimiş 
on=üstünde 
once=bir kere 
one=bir 
onion=soğan 
online=bağlantılı 
only=tek 
open=açılmak 
opinion=kanaat 
opposite=zıt 
or=ya da
orange=portakal 
order=sipariş vermek 
other=öbür 
our=bizim 
out=çıkış 
outside=dıştan 
over=bitmiş 
own=sahip olmak 
page=sayfa 
paint=boyamak 
painting=tablo 
pair=çift 
paper=kağıt 
paragraph=fıkra 
parent=ebeveynlik etmek 
park=park etmek 
part=parça 
partner=eş 
party=taraf 
passport=geçiş belgesi 
past=geçmiş 
pay=ödemek 
pen=kalem 
pencil=kalem 
people=insanlar 
pepper=biber 
perfect=kusursuz 
period=devir 
person=kişi 
personal=kişisel 
phone=telefon etmek 
photo=foto 
photograph=fotoğraflamak 
phrase=ifade etmek 
piano=piyano çalgı 
picture=resim 
piece=tane 
pig=domuz 
pink=pembe 
place=koymak 
plan=planlamak 
plane=düzlemek 
plant=dikmek 
play=oynamak 
player=oyuncu 
please=memnun etmek 
point=nokta 
police=polis 
policeman=polis 
pool=havuz 
poor=kötü 
popular=popüler 
positive=pozitif 
possible=olabilir 
post=postalamak 
potato=patates 
pound=yumruklamak 
practice=uygulamak 
practise=pratik yapmak 
prefer=tercih etmek 
prepare=hazırlamak 
present=sunmak 
pretty=şirin 
price=bedel 
probably=galiba 
problem=problem 
product=ürün 
programme=program 
project=proje 
purple=mor 
put=koymak 
quarter=çeyrek 
question=soru 
quick=süratli 
quickly=hızla 
quiet=sessizlik 
quite=epeyce 
radio=radyo 
rain=yağmur yağmak 
read=okumak 
reader=okur 
reading=okuma 
ready=hazır 
real=hakiki 
really=hakikaten 
reason=sebep 
red=al 
relax=rahatlamak 
remember=hatırlamak 
repeat=yinelemek 
report=haber vermek 
restaurant=restoran 
result=netice 
return=geri dönmek 
rice=pirinç 
rich=zengin 
ride=binmek 
right=sağ 
river=nehir 
road=yol 
room=oda 
routine=rutin 
rule=hüküm sürmek 
run=çalıştırmak 
sad=hüzünlü 
salad=salata 
salt=tuz 
same=aynı 
sandwich=sandviç 
Saturday=cumartesi 
say=söylemek 
school=mektep 
science=ilim 
scientist=bilgin 
sea=deniz 
second=saniye 
section=kesit 
see=görmek 
sell=satılmak 
send=yollamak 
sentence=cümle 
September=eylül 
seven=yedi 
seventeen=XVII 
seventy=yetmiş 
share=paylaşmak 
she=dişi hayvan 
sheep=koyun 
shirt=gömlek 
shoe=ayakkabı 
shop=mağaza 
shopping=alışveriş 
short=az 
should=gerekmek 
show=göstermek 
shower=sağanak 
sick=hasta 
similar=benzer 
sing=söylemek 
singer=şarkıcı 
sister=abla 
sit=oturmak 
situation=hal 
six=şeş 
sixteen=onaltı 
sixty=altmış 
skill=maharet 
skirt=etek 
sleep=uyumak 
slow=yavaşlatmak 
small=az 
snake=yılan 
snow=kar 
so=bu yüzden 
some=biraz 
somebody=biri 
someone=birisi 
something=bir şey 
sometimes=bazen 
son=oğul 
song=şarkı 
soon=birazdan 
sorry=üzgün 
sound=ses 
soup=çorba 
south=güney 
space=aralık 
speak=konuşmak 
special=özel 
spell=hecelemek 
spelling=yazım 
spend=geçirmek (geceyi vb) 
sport=spor 
spring=memba 
stand=(teklif) geçerli olmak 
star=yıldız 
start=başlamak 
statement=ifade 
station=terminal 
stay=kalmak 
still=durgun 
stop=durmak 
story=hikaye 
street=cadde 
strong=güçlü 
student=öğrenci 
study=incelemek 
style=biçim 
subject=ders 
success=muvaffakiyet 
sugar=şeker 
summer=yaz 
sun=güneş 
Sunday=pazar 
supermarket=süpermarket 
sure=emin 
sweater=süveter 
swim=yüzmek 
swimming=yüzme 
table=masa 
take=almak 
talk=konuşmak 
tall=uzun 
taxi=taksi 
tea=çay 
teach=ders vermek 
teacher=öğretmen 
team=takım 
telephone=telefon 
television=televizyon 
tell=haber vermek 
ten=on 
tennis=tenis 
terrible=berbat 
test=sınamak 
text=metin 
than=-den 
thank=teşekkür etmek 
thanks=teşekkür 
that=şu 
theatre=tiyatro 
their=onların 
them=onlara 
then=o zamanlar 
there=oraya 
they=onlar 
thing=şey 
think=sanmak 
third=üçte bir 
thirsty=susuz 
thirteen=on üç sayısı (13, XIII) 
thirty=otuz sayısı (30, XXX) 
this=bu 
thousand=bin 
three=iskambilde üçlü 
through=başından sonuna kadar 
Thursday=perşembe 
ticket=bilet 
time=kez 
tired=argın 
title=unvan 
to=karşı 
today=bugün 
together=birlikte 
toilet=hela 
tomato=domates 
tomorrow=yarın 
tonight=akşama 
too=gereğinden çok 
tooth=diş 
topic=konu 
tourist=turist 
town=şehir 
traffic=gidiş geliş 
train=eğitim vermek 
travel=gezmek 
tree=ağaç 
trip=seyahat 
trousers=pantolon 
TRUE=hakiki 
try=denemek 
T-shirt=tişört 
Tuesday=salı 
turn=dönmek 
TV=televizyon 
twelve=oniki 
twenty=yirmi 
twice=iki kez 
two=iki 
type=yazmak 
umbrella=şemsiye 
uncle=dayı 
under=altında 
understand=anlayış göstermek 
university=üniversite 
until=ila 
up=yukarı 
upstairs=üst kat 
us=biz 
use=kullanmak 
useful=faydalı 
usually=genellikle 
vacation=tatil 
vegetable=sebze 
very=çok 
video=video terminal 
village=köy 
visit=ziyaret etmek 
visitor=ziyaretçi 
wait=beklemek 
waiter=garson 
wake=canlanmak 
walk=yürümek 
wall=duvar 
want=istemek 
warm=ısıtmak 
wash=yıkanmak 
watch=seyretmek (tv) 
water=sulamak 
way=yol 
we=biz 
wear=giymek 
weather=hava 
website=internet sitesi 
Wednesday=çarşamba 
week=hafta 
weekend=hafta sonu 
welcome=hoş geldiniz 
well=fışkırmak 
west=batı 
what=ne 
when=ne zaman 
where=nereye 
which=hangi 
white=beyaz 
who=kimi 
why=neden 
wife=kocanın eşi 
will=vasiyet 
win=kazanmak 
window=pencere 
wine=şarap sunmak 
winter=kış 
with=ile 
without=dış 
woman=kadın 
wonderful=müthiş 
word=laf 
work=çalışmak 
worker=işçi 
world=alem 
would=istemek 
write=yazmak 
writer=yazar 
writing=yazma 
wrong=yanlış 
yeah=tamam 
year=yıl 
yellow=sarı 
yes=evet 
yesterday=dün 
you=siz 
young=genç 
your=senin 
yourself=kendiniz 
