ability=hüner 
able=hünerli 
abroad=yurt dışında 
accept=kabullenmek 
accident=rastlantı 
according to=göre 
achieve=elde etmek 
act=davranmak 
active=faal 
actually=fiilen 
adult=yetişkin 
advantage=avantaj 
adventure=macera 
advertise=reklamını yapmak 
advertisement=reklam 
advertising=reklamcılık 
affect=etkilemek 
after=sonra 
against=aykırı 
ah=of 
airline=hava yolu 
alive=diri 
all=tüm 
all right=kuşkusuz ki
allow=izin vermek 
almost=hemen hemen 
alone=yalnız 
along=boyunca 
already=zaten 
alternative=alternatif 
although=her ne kadar 
among=arasına 
amount=miktar 
ancient=antik 
angrily=hiddetle 
ankle=ayak bileği 
any=lalettayin 
any more=başka 
anybody=kimse 
anyway=neyse 
anywhere=nerede olursa olsun 
app=uygulama
appear=belli olmak 
appearance=dış görünüş 
apply=uygulamak 
architect=mimar 
architecture=mimarlık 
argue=tartışmak 
argument=argüman 
army=ordu 
arrange=ayarlamak 
arrangement=ayarlama 
as=olarak 
asleep=uyuyan 
assistant=muavin 
athlete=sporcu 
attack=saldırmak 
attend=katılmak 
attention=özen 
attractive=cazibeli 
audience="izleyiciler veya dinleyiciler
topluluğu "
author=yazar 
available=elde hazır bulunan 
average=ortalama 
avoid=önlemek 
award=ödüllendirmek 
awful=berbat 
back=art 
background=arka plan 
badly=kötü bir şekilde 
bar=çubuk 
baseball=beysbol 
based=esaslı 
basketball=basketbol 
bean=fasulye 
bear=dayanmak 
beat=vurmak 
beef=dırlanmak 
before=evvel 
behave=davranmak 
behaviour=davranış 
belong=(birine) ait olmak 
belt=kayış 
benefit=yararlanmak 
best=en iyi 
better=daha iyi 
between=arasında 
billion=milyar 
bin=çöp kutusu 
biology=dirimbilim 
birth=doğum 
biscuit=bisküvi 
bit=gem 
blank=boşluk 
blood=kan 
blow=esmek 
board=binmek 
boil=haşlamak 
bone=kılçık 
book=ayırtmak 
borrow=ödünç almak 
boss=patron 
bottom=dip 
bowl=tas 
brain=beyin 
bridge=köprü 
bright=parlak 
brilliant=nefis 
broken=arızalı 
brush=fırçalamak 
burn=yakmak 
businessman=işadamı 
button=düğme 
camp=kamp yapmak 
camping=kamp yapma 
can=olabilmek 
care=önem vermek 
careful=itinalı 
carefully=özenle 
carpet=halı 
cartoon=karikatürize etmek 
case=dava 
cash=nakit 
castle=kale 
catch=enselemek 
cause=sebebiyet vermek 
celebrate=kutlamak 
celebrity=ünlü kişi 
certain=kesin 
certainly=muhakkak 
chance=olanak 
character=karakter 
charity=hayır 
chat=muhabbet 
check=denetlemek 
chef=aşçı 
chemistry=yapı 
chip=havalandırmak (top) 
choice=tercih 
church=kilise 
cigarette=sigara 
circle=halka 
classical=klasik 
clear=belirgin 
clearly=açık bir biçimde 
clever=zeki 
climate=iklim 
close=kapamak 
closed=kapalı 
clothing=giysi 
cloud=bulut 
coach=otobüs 
coast=sahil 
code=şifrelemek 
colleague=meslektaş 
collect=toplamak 
column=sütun 
comedy=komedi 
comfortable=rahat 
comment=yorumlamak 
communicate=haberleşmek 
community=halk 
compete=rekabet etmek 
competition=müsabaka 
complain=yakınmak 
completely=büsbütün 
condition=şartlandırmak 
conference=konferans 
connect=bağlamak 
connected=bağlı 
consider=durumu değerlendirmek 
contain=kapsamak 
context=bağlam 
continent=kıta 
continue=devam ettirmek 
control=denetlemek 
cook=yemek pişirmek 
cooker=ocak 
copy=kopyalamak 
corner=köşe 
correctly=doğru 
count=saymak 
couple=eşleştirmek 
cover=örtmek 
crazy=deli 
creative=yaratıcı 
credit=kredi 
crime=suç 
criminal=sabıkalı 
cross=karşıya geçmek 
crowd=kalabalık 
crowded=kalabalık 
cry=haykırmak 
cupboard=dolap 
curly=kıvırcık 
cycle=devir 
daily=günlük 
danger=tehlike 
dark=karanlık 
data=veri 
dead=ölü 
deal=davranmak 
dear=sevgili 
death=ölüm 
decision=karar 
deep=derin 
definitely=kesinlikle 
degree=derece 
dentist=dişçi 
department=departman 
depend=bağlı olmak 
desert=terk etmek 
designer=tasarımcı 
destroy=tahrip etmek 
detective=dedektif 
develop=geliştirmek 
device=cihaz 
diary=günlük 
differently=farklı olarak 
digital=dijital 
direct=yönlendirmek 
direction=istikamet 
director=yönetici 
disagree=aynı fikirde olmamak 
disappear=ortadan kaybolmak 
disaster=facia 
discover=keşfetmek 
discovery=buluş 
discussion=tartışma 
disease=hastalık 
distance=mesafe 
divorced=ayrılmış 
document=doküman 
double=iki misli yapmak 
download=indirmek 
downstairs=aşağı katta 
drama=piyes 
drawing=çizme 
dream=rüya görmek 
drive=sürmek 
driving=sürme 
drop=düşmek 
drug=ilaç 
dry=kurulamak 
earn=para kazanmak 
earth=kara 
easily=rahatlıkla 
education=öğretim 
effect=tesir 
either=iki 
electric=elektrik 
electrical=elektrik 
electricity=elektrik 
electronic=elektronik 
employ=işe almak 
employee=işçi 
employer=işveren 
empty=boşaltmak 
ending=bitiş 
energy=enerji 
engine=motor 
engineer=mühendis 
enormous=kocaman 
enter=girmek 
environment=çevre 
equipment=teçhizat 
error=yanlışlık 
especially=özellikle 
essay=kalkışmak 
everyday=olağan 
everywhere=her yer 
evidence=kanıt 
exact=kesin 
exactly=tamamen 
excellent=mükemmel 
except=haricinde 
exist=var olmak 
expect=ummak 
experience=deneyim 
experiment=deney 
expert=bilirkişi 
explanation=açıklama 
express=ifade etmek 
expression=anlatım 
extreme=aşırı 
extremely=gayetle 
factor=etken 
factory=fabrika 
fail=başarısızlığa uğramak 
fair=panayır 
fall=inmek 
fan=pervane 
farm=çiftlik 
farming=çiftçilik 
fashion=moda 
fat=semirtmek 
fear=korkmak 
feature=özellik 
feed=beslemek 
female=dişi 
fiction=kurgu 
field=tarla 
fight=dövüşmek 
figure=rakam 
film=film 
final=final 
finally=nihayet 
finger=parmak 
finish=sona ermek 
first=birinci 
firstly=ilk önce 
fish=balık 
fishing=balık tutma 
fit=uymak 
fix=düzeltmek 
flat=düz yüzey 
flu=grip 
fly=uçmak 
flying=uçma 
focus=odaklanmak 
following=taraftarlar 
foreign=yabancı 
forest=orman 
fork=çatal 
formal=resmi 
fortunately=şükür ki 
forward=ileri 
free=bağımsız 
fresh=taze 
fridge=frijider 
frog=kurbağa 
fun=eğlence 
furniture=mobilya 
further=daha ileri 
future=istikbal 
gallery=galeri 
gap=açıklık 
gas=benzin 
gate=kapı 
general=genel 
gift=allah vergisi 
goal=gaye 
god=Allah 
gold=altın 
golf=golf oynamak 
good=güzel 
government=hükümet 
grass=otlak 
greet=selamlaşmak 
ground=yer 
guest=davetli 
guide=yol göstermek 
gun=silah 
guy=adam 
habit=alışkanlık 
half=yarım 
hall=hol 
happily=mutlu bir şekilde 
have=sahip olmak 
headache=baş belası 
heart=gönül 
heat=ısıtmak 
heavy=ağır 
height=yükseklik 
helpful=yardımsever 
hero=kahraman 
hers=dişil onunki 
herself=kendisine 
hide=saklamak 
high=yüksek 
hill=tepe 
himself=bizzat 
his=eril onunki 
hit=çarpmak 
hockey=hokey 
hold=sahip olmak 
hole=çukur 
home=ev 
hope=ummak 
huge=iri 
human=insan 
hurt=acımak 
ideal=ülkü 
identify=tanımlamak 
ill=hasta 
illness=hastalık 
image=şekil 
immediately=hemen 
impossible=olanaksız 
included=dahil olan 
including=kapsama 
increase=arttırmak 
incredible=inanılmaz 
independent=bağımsız 
individual=birey 
industry=endüstri 
informal=resmi olmayan 
injury=zarar 
insect=böcek 
inside=iç taraf 
instead=yerine 
instruction=öğretme 
instructor=eğitmen 
instrument=enstrüman 
intelligent=akıllı 
international=devletlerarası 
introduction=giriş 
invent=icat etmek 
invention=buluş 
invitation=davetiye 
invite=davet etmek 
involve=kapsamak 
item=kalem 
itself=kendisi 
jam=kıstırmak 
jazz=caz 
jewellery=mücevherat 
joke=komiklik 
journalist=gazeteci 
jump=sıçramak 
kid=velet 
kill=katletmek 
king=kral 
knee=diz 
knife=bıçak 
knock=kapı çalmak 
knowledge=bilgi 
lab=laboratuvar 
lady=bayan 
lake=göl 
lamp=ampul 
land=karaya ayak basmak 
laptop=dizüstü bilgisayar 
last=sonuncu 
later=sonradan 
laughter=kahkaha 
law=yasa 
lawyer=avukat 
lazy=uyuşuk 
lead=yol göstermek 
leader=lider 
learning=öğrenme 
least=en az 
lecture=ders anlatmak 
lemon=limon 
lend=ödünç vermek 
less=daha az 
level=seviye 
lifestyle=yaşam tarzı 
lift=havalanmak 
light=aydınlık 
likely=büyük ihtimalle 
link=bağlamak 
listener=dinleyici 
little=ufak 
lock=kilitlemek 
look=bakmak 
lorry=kamyon 
lost=kayıp 
loud=yüksek (ses) 
loudly=yüksek sesle 
lovely=güzel 
low=alçak 
luck=şans 
lucky=talihli 
mail=postalamak 
major=asıl 
male=erkek 
manage=işletmek 
manager=menajer 
manner=yol 
mark=işaretlemek 
marry=evlenmek 
material=materyal 
mathematics=matematik 
maths=matematik 
matter=önemli olmak 
may=mayıs ayı 
media=medya 
medical=medikal 
medicine=tıp 
memory=anı 
mention=değinmek 
metal=madenle kaplamak 
method=metot 
middle=orta 
might=mümkün olmak 
mind=önemsemek 
mine=maden 
mirror=ayna 
missing=özlem 
mobile=mobil 
monkey=maymun 
moon=ay 
mostly=çoğunlukla 
motorcycle=motor 
movement=hareket 
musical=müzikli 
musician=müzisyen 
myself=kendim 
narrow=dar 
national=ulusal 
nature=mahiyet 
nearly=hemen hemen 
necessary=gereken 
neck=boyun 
need=ihtiyaç duymak 
neither=hiçbir 
nervous=gergin 
network=ağ 
noise=ses 
noisy=gürültücü 
none=hiçbiri 
normal=olağan 
normally=normalde 
notice=farkına varmak 
novel=roman 
nowhere=hiçbir yer 
number=numaralamak 
nut=fındık 
ocean=okyanus 
offer=teklif vermek 
officer=memur 
oil=yağ 
onto=üstüne 
opportunity=olanak 
option=seçenek 
ordinary=sıradan 
organization=organizasyon 
organize=organize etmek 
original=özgün 
ourselves=kendimiz 
outside=dıştan 
oven=ocak 
own=sahip olmak 
owner=mal sahibi 
pack=ambalajlamak 
pain=sancı 
painter=boyacı 
palace=saray 
pants=pantolon 
parking=park 
particular=özel 
pass=geçirmek 
passenger=yolcu 
past=geçmiş 
patient=hasta 
pattern=modele göre yapmak 
pay=ödemek 
peace=sulh 
penny=metelik 
per=her 
per cent=yüzde 
perform=rol yapmak 
perhaps=belki 
permission=müsaade 
personality=kişilik 
pet=evde beslenen hayvan 
petrol=petrol 
photograph=fotoğraflamak 
physical=bedensel 
physics=fizik 
pick=seçmek 
pilot=pilot 
planet=gezegen 
plant=dikmek 
plastic=plastik 
plate=plaka 
platform=platform 
please=memnun etmek 
pleased=memnun 
pocket=cep 
polite=nazik 
pollution=kirlilik 
pop=patlatmak 
population=nüfus 
position=mevki 
possession=sahiplik 
possibility=olasılık 
poster=afiş 
power=yetki 
predict=öngörmek 
present=sunmak 
president=başkan 
prevent=engellemek 
print=yazdırmak 
printer=yazıcı 
prison=hapishane 
prize=ödül 
process=işlemek 
produce=üretmek 
professional=profesyonel 
professor=profesör 
profile=profil 
program=programlamak 
progress=gelişmek 
promise=söz vermek 
pronounce=telaffuz etmek 
protect=korumak 
provide=sağlamak 
pub=taverna 
public=halk 
publish=yayınlamak 
pull=çekmek 
purpose=gaye 
push=itelemek 
quality=kalite 
quantity=nicelik 
queen=kraliçe 
question=soru 
quietly=sessizce 
race=yarışmak 
railway=tren yolu 
raise=büyütmek (çocuk) 
rate=kur 
rather=oldukça 
reach=ulaşmak 
react=tepki göstermek 
realize=gerçekleştirmek 
receive=teslim almak 
recent=son 
recently=son dönemlerde 
reception=resepsiyon 
recipe=yemek tarifi 
recognize=tanımak 
recommend=tavsiye etmek 
record=kaydetmek 
recording=kayıt 
recycle=geri dönüştürmek 
reduce="(daha basit bir hale) dönüştürmek"
refer=anmak 
refuse=geri çevirmek 
region=bölge 
regular=müdavim 
relationship=ilişki 
remove=kaldırmak 
repair=tamir etmek 
replace=yer değiştirmek 
reply=yanıtlamak 
report=haber vermek 
reporter=muhbir 
request=rica etmek 
research=incelemek 
researcher=araştırmacı 
respond=yanıtlamak 
response=cevap 
rest=dinlendirmek 
review=gözden geçirmek 
ride=binmek 
ring=çalmak (telefon/zil) 
rise=doğmak 
rock=sallanmak 
role=rol 
roof=çatı 
round=yuvarlak 
route=güzergah 
rubbish=zırva 
rude=nezaketsiz 
run=çalıştırmak 
runner=haberci 
running=çalışma 
sadly=üzüntülü bir şekilde 
safe=kasa 
sail=denize açılmak 
sailing=denize açılma 
salary=aylık 
sale=satış 
sauce=sos 
save=(para) biriktirmek 
scared=korkmuş 
scary=ürkütücü 
scene=sahne 
schedule=plan 
score=puan 
screen=ekran 
search=araştırmak 
season=sezon 
seat=oturtmak 
secondly=saniyen 
secret=sır 
secretary=sekreter 
seem=gözükmek 
sense=algılamak 
separate=ayırmak 
series=seri 
serious=ciddi 
serve=hizmet etmek 
service=servis 
several=birçok 
shake=sallanmak 
shall="kararlılık, niyet
shape=şekillendirmek 
sheet=levha 
ship=gemi 
shoulder=omuz 
shout=bağırmak 
shut=kapamak 
side=kenar 
sign=imzalamak 
silver=gümüş 
simple=sade 
since=ondan sonra 
singing=şan 
single=bekar 
sir=sör diye hitap etmek 
site=yerleştirmek 
size=büyüklük 
ski=kayak 
skiing=kayak 
skin=soymak 
sky=gök 
sleep=uyumak 
slowly=yavaş yavaş 
smell=koklamak 
smile=gülümsemek 
smoke=sigara içmek 
smoking=sigara içme 
soap=sabun 
soccer=futbol 
social=sosyal 
society=toplum 
sock=çorap 
soft=cıvık 
soldier=asker 
solution=çözelti 
solve=çözmek 
somewhere=bir yere 
sort=sıralamak 
source=kaynak 
speaker=hoparlör 
specific=belirli 
speech=konuşma 
speed=sürat 
spider=örümcek 
spoon=kaşık 
square=meydan 
stage=sahneye koymak 
stair=merdiven basamağı 
stamp=damga vurmak 
star=yıldız 
start=başlamak 
state=ifade etmek 
stay=kalmak 
steal=aşırmak 
step=üvey 
stomach=mide 
stone=taş 
store=depolamak 
storm=fırtına 
straight=düzgün 
strange=garip 
strategy=strateji 
stress=stres 
structure=yapılandırmak 
stupid=aptalca 
succeed=başarılı olmak 
successful=başarılı 
such=çok 
suddenly=birdenbire 
suggest=önermek 
suggestion=telkin 
suit=uygun olmak 
support=desteklemek 
suppose=farz etmek 
sure=emin 
surprise=şaşırtmak 
surprised=şaşırmış 
surprising=şaşırtıcı 
survey=araştırma 
sweet=tatlı 
symbol=sembol 
system=sistem 
tablet=tablet 
talk=konuşmak 
target=hedef 
task=görev 
taste=tatmak 
teaching=öğretmenlik 
technology=teknoloji 
teenage=13 19 yaş arası 
temperature=sıcaklık 
term=isimlendirmek 
themselves=kendileri 
thick=kalın 
thief=hırsız 
thin=inceltmek 
thinking=düşünme 
third=üçte bir 
thought=sanı 
throw=fırlatmak 
tidy=düzenli 
tie=bağlamak 
tip=bahşiş 
tool=alet 
top=tepe 
touch=ellemek 
tour=gezmek 
tourism=turizm 
towards=doğru 
towel=havlu 
tower=kule 
toy=oyuncak 
track=izlemek (iz vb) 
tradition=gelenek 
traditional=geleneksel 
train=eğitim vermek 
trainer=eğitimci 
training=eğitim 
transport=taşımak 
traveller=seyahat eden kimse 
trouble=sorun 
truck=kamyon 
twin=ikiz 
typical=tipik 
underground=yeraltı 
understanding=kavrayış 
unfortunately=maalesef 
unhappy=mutsuz 
uniform=forma 
unit=birim 
united=birleşmiş 
unusual=alışılmadık 
upstairs=üst kat 
use=kullanmak 
used to=alışık 
user=kullanıcı 
usual=olağan 
valley=vadi 
van=elebaşı 
variety=çeşitlilik 
vehicle=araç 
view=incelemek 
virus=virüs 
voice=ses 
wait=beklemek 
war=harp 
wash=yıkanmak 
washing=yıkanma 
wave=dalgalanmak 
weak=halsiz 
web=etrafına ağ çekmek 
wedding=nikah 
weight=ağırlık yapmak 
welcome=hoş geldiniz 
wet=ıslatmak 
wheel=çark 
while=sırasında 
whole=tam 
wide=geniş 
wild=yaban 
wind=sarmak 
winner=galip 
wish=dilemek 
wood=odun 
wooden=ahşap 
working=çalışma 
worried=endişeli 
worry=endişelenmek 
worse=daha kötüsü 
worst=yenmek 
yet=henüz 
yours=seninki 
zero=sıfır 

