absolutely=kesinlikle 
academic=akademik 
access=erişim
accommodation=konaklama
account=hesap
achievement=başarı
act=davranmak 
ad=reklam
addition=ek
admire=hayranlık duymak 
admit=itiraf etmek 
advanced=ileri 
advise=öğütlemek 
afford=parası yetmek 
age=yaş
aged=yaşlı 
agent=ajan
agreement=mutabakat
ahead=ilerde 
aim=amaçlamak 
alarm=alarm
album=plak
alcohol=alkol
alcoholic=alkolik
alternative=alternatif
amazed=hayrete düşürülmüş 
ambition=ihtiras
ambitious=hırslı 
analyse=incelemek 
analysis=çözümleme
announce=anons etmek 
announcement=anons
annoy=rahatsız etmek 
annoyed=sinirli 
annoying=musallat
apart=ayrı 
apologize=özür dilemek 
application=tatbik
appointment=tayin
appreciate=değerini artırmak 
approximately=takriben 
arrest=tutuklamak 
arrival=varış
assignment=görevlendirme
assist=yardım etmek 
atmosphere=atmosfer
attach=yapıştırmak 
attitude=tutum
attract=cezbetmek 
attraction=çekicilik
authority=otorite
average=ortalama
award=ödüllendirmek 
aware=haberdar 
backwards=geriye 
bake=kurutmak 
balance=dengede tutmak 
ban=yasaklamak 
base=dayandırmak 
basic=temel 
basis=temel
battery=akü
battle=savaş
beauty=güzellik
bee=arı
belief=inanma
bell=çan
bend=bükülmek 
benefit=yararlanmak 
better=daha iyi 
bite=ısırmak 
block=engellemek 
board=binmek 
bomb=bombalamak 
border=hudut
bother=dert vermek 
branch=dallanmak 
brand=marka
brave=yiğit 
breath=nefes
breathe=soluk almak 
breathing=an
bride=gelin
bubble=fokurdamak 
bury=gömmek 
by=geçecek biçimde 
calm=sakinleştirmek 
campaign=sefer
campus=kampus
candidate=aday
cap=başlık
captain=kaptan
careless=umursamaz 
category=kategori
ceiling=tavan
celebration=kutlama
central=orta 
centre=merkez
ceremony=merasim
chain=zincir
challenge=düelloya davet etmek 
champion=şampiyon 
channel=kanal
chapter=bölüm
charge=yüklemek (enerji/elektrik) 
cheap=ucuz 
cheat=kopya çekmek 
cheerful=neşeli 
chemical=kimyasal atık
chest=göğüs
childhood=çocukluk
claim=talep etmek 
clause=fıkra
clear=belirgin 
click=tıkırdamak 
client=müvekkil
climb=tırmanmak 
close=kapamak 
cloth=kumaş
clue=ipucu
coach=otobüs
coal=kömür
coin=madeni para
collection=toplama
coloured=renkli 
combine=birleştirmek 
comment=yorumlamak 
commercial=ticari 
commit=işlemek (suç vb) 
communication=iletişim
comparison=mukayese
competitive=rekabetçi 
competitor=yarışmacı
complaint=şikayet
complex=karışık 
concentrate=yoğunlaşmak 
conclude=sonuçlandırmak 
conclusion=sonuç
confident=kendinden emin 
confirm=onaylamak 
confuse=kafasını karıştırmak 
confused=şaşkın 
connection=bağ
consequence=netice
consist=-den meydana gelmek 
consume=tüketmek 
consumer=tüketici
contact=ilişki kurmak 
container=konteyner
content=içerik
continuous=sürekli 
contrast=karşılaştırmak 
convenient=müsait 
convince=ikna etmek 
cool=soğutmak 
costume=elbise giymek 
cottage=kulübe
cotton=pamuklu 
count=saymak 
countryside=kırsal kesim
court=mahkeme
cover=örtmek 
covered=örtülü 
cream=kaymak
criminal=sabıkalı
cruel=zalim 
cultural=kültürel 
currency=döviz
current=akım
currently=halen 
curtain=perde
custom=görenek
cut=kesmek 
daily=günlük 
damage=zarar vermek 
deal=davranmak 
decade=10 yıl
decorate=dekore etmek 
deep=derin 
define=tanımlamak 
definite=belirli 
definition=tanım
deliver=teslim etmek 
departure=kalkış
despite=rağmen [ed.]
destination=varış yeri
determine=azmetmek 
determined=azimli 
development=gelişim
diagram=grafik
diamond=elmas
difficulty=zorluk
direct=yönlendirmek 
directly=doğrudan doğruya 
dirt=pislik
disadvantage=dezavantaj
disappointed=hayal kırıklığına uğramış 
disappointing=heves kırıcı 
discount=tenzilat
dislike=hoşlanmama
divide=bölmek 
documentary=belgesel 
donate=bağışta bulunmak 
double=iki misli yapmak 
doubt=kuşkulanmak 
dressed=giyinmiş 
drop=düşmek 
drum=davul
drunk=sarhoş
due=vadesi dolmuş 
dust=toz
duty=görev
earthquake=deprem
eastern=doğuya ait 
economic=ekonomik 
economy=iktisat
edge=eşik (kıyamet/sorun vb)
editor=editör
educate=eğitmek 
educated=yetişmiş 
educational=eğitsel 
effective=efektif 
effectively=etkili bir şekilde 
effort=efor
election=seçim
element=eleman
embarrassed=mahcup 
embarrassing=can sıkıcı 
emergency=acil vaka
emotion=his
employment=iş verme
empty=boşaltmak 
encourage=cesaretlendirmek 
enemy=hasım
engaged=bağlanmış 
engineering=mühendislik
entertain=eğlendirmek 
entertainment=eğlence
entrance=giriş
entry=giriş
environmental=çevre 
episode=parça
equal=denk 
equally=eşit olarak 
escape=kaçmak 
essential=ana 
eventually=eninde sonunda 
examine=muayene etmek 
except=haricinde [ed.]
exchange=takas etmek 
excitement=heyecan
exhibition=sergi
expand=yayılmak 
expected=beklenen 
expedition=sefer
experience=deneyim
experienced=tecrübeli 
experiment=deney
explode=patlatmak 
explore=keşfetmek 
explosion=infilak
export=ihraç etmek 
extra=ekstra 
face=yüzleşmek 
fairly=büsbütün 
familiar=aşina 
fancy=süslü 
far=uzak 
fascinating=büyüleyici 
fashionable=modaya uygun 
fasten=bağlamak 
favour=iyilik etmek 
fear=korkmak 
feature=özellik
fence=çit
fighting=kavga
file=eğe
financial=mali 
fire=ateşlemek 
fitness=formda olma
fixed=durağan 
flag=sancak
flood=sel basmak 
flour=un
flow=akmak 
fold=bükülmek 
folk=halk
following=taraftarlar
force=zorlamak 
forever=ilelebet 
frame=çerçeve
freeze=donmak 
frequently=sık sık 
friendship=dostluk
frighten=korkutmak 
frightened=ürkmüş 
frightening=korkutucu 
frozen=dondurulmuş 
fry=yağda kızartmak 
fuel=yakıt
function=işlev
fur=kürk
further=daha ileri 
garage=tamirhane
gather=toplanmak 
generally=genelde 
generation=üretme
generous=eli açık 
gentle=yumuşak ve nazik 
gentleman=centilmen
ghost=ruh
giant=dev 
glad=memnun 
global=küresel 
glove=eldiven
go=hareket etmek 
goods=mal
grade=puanlamak 
graduate=mezun olmak 
grain=tahıl
grateful=minnettar 
growth=büyüme
guard=korumak 
guilty=suçlu 
hand=el
hang=asmak 
happiness=mutluluk
hardly=ancak 
hate=nefret etmek 
head=kelle
headline=manşet
heating=ısınma
heavily=aşırı derecede 
helicopter=helikopter
highlight=belirtmek (altını çizerek) 
highly=ziyadesiyle 
hire=kiralamak 
historic=tarihi
historical=tarihi 
honest=namuslu 
horrible=berbat 
horror=korku
host=ağırlamak 
hunt=avlanmak 
hurricane=kasırga
hurry=acele etmek 
IT=ona [zm.]
identity=kimlik
ignore=görmezden gelmek 
illegal=kaçak 
imaginary=hayali 
immediate=acil 
immigrant=göçmen 
impact=darbe
import=ithal etmek 
importance=önem
impression=izlenim
impressive=etkileyici 
improvement=gelişim
incredibly=inanılmaz bir şekilde 
indeed=doğrusu 
indicate=göstergesi olmak 
indirect=dolaylı 
indoor=kapalı mekan
indoors=içeriye 
influence=tesir etmek 
ingredient=cüz
injure=sakatlamak 
injured=yaralı 
innocent=masum 
intelligence=istihbarat
intend=niyet etmek 
intention=maksat
invest=yatırım yapmak 
investigate=araştırmak 
involved=ilgili 
iron=ütülemek 
issue=(dergi/gazete) nüsha
journal=dergi
judge=yargılamak 
keen=hevesli 
key=anahtar
keyboard=klavye
kick=tekmelemek 
killing=öldürme
kind=tür
kiss=öpmek 
knock=kapı çalmak 
label=etiketlemek 
laboratory=laboratuvar
lack=yokluk
latest=son 
lay=sermek 
layer=katman
lead=yol göstermek 
leading=öncülük eden 
leaf=yaprak vermek 
leather=deri
legal=tüzel 
leisure=boş vakit
length=uzunluk
level=seviye
lie=yatmak 
like=beğenmek 
limit=sınırlandırmak 
lip=dudak
liquid=sıvı
literature=literatür
live=yaşamak 
living=canlı 
local=lokal 
locate=yerini saptamak 
located=yeri tayin edilmiş
location=yer
lonely=yalnız 
loss=zarar
luxury=lüks
mad=kızgın 
magic=sihirbazlık
mainly=daha çok 
mall=vurmak 
management=işletme
market=çarşı
marketing=pazarlama
marriage=evlenme
meanwhile=aynı anda 
measure=ölçmek 
medium=orta
mental=akli 
mention=değinmek 
mess=karışıklık
mild=ılıman 
mine=maden
mix=karıştırmak 
mixture=karışım
mood=ruh hali
move=kımıldamak 
mud=çamur
murder=cinayet işlemek 
muscle=adale
musical=müzikli 
mystery=sır
nail=çivilemek 
narrative=anlatı
nation=ulus
native=yerli 
naturally=doğal olarak 
necessarily=muhakkak 
need=ihtiyaç duymak 
needle=iğnelemek 
neighbourhood=mahalle
neither=hiçbir 
net=şebeke
next=sonraki [ed.]
nor=ne de [bağ.]
normal=olağan 
northern=kuzeyli 
note=not etmek 
now=şimdi 
nuclear=nükleer 
obvious=besbelli 
obviously=besbelli 
occasion=vesile
occur=meydana gelmek 
odd=acayip 
official=memur
old-fashioned=eski 
once=bir kere 
operation=operasyon
organized=teşkilatlı 
organizer=organizatör
original=özgün 
originally=aslen 
ought=gerekli 
ours=bizim [zm.]
outdoor=açıkhava 
outdoors=açık hava
pack=ambalajlamak 
package=paketlemek 
painful=ağrılı 
pale=solgun 
pan=tava
participate=katılmak 
particularly=özellikle 
pass=geçirmek 
passion=hırs
path=yol
payment=ödeme
peaceful=huzurlu 
percentage=yüzde
perfectly=mükemmelen 
performance=performans
personally=şahsen 
persuade=ikna etmek 
photographer=fotoğrafçı
photography=fotoğrafçılık
pin=raptiye
pipe=boru
place=koymak 
planning=planlama
pleasant=güzel 
pleasure=zevk
plenty=bolluk
plot=komplo kurmak 
plus=artı 
poem=şiir
poet=şair
poetry=şiir
point=nokta
poison=zehirlemek 
poisonous=zehirli 
policy=politika
political=politik 
politician=politikacı
politics=siyaset
port=liman
portrait=portre
possibly=muhtemelen 
pot=çanak
pour=dökmek 
poverty=sefalet
powder=toz
powerful=güçlü 
practical=tatbiki 
pray=dua etmek 
prayer=dua
prediction=tahmin
prepared=hazır 
presentation=sunum
press=basmak 
pressure=basınç
pretend=yapar gibi görünmek 
previous=önceki 
previously=önceden 
priest=papaz
primary=ana 
prince=prens
princess=sultan
printing=basım
prisoner=esir
private=er
producer=yapımcı
production=üretme
profession=meslek
profit=kar
program=programlamak 
promote=tanıtımını yapmak 
proper=uygun 
properly=uygun bir şekilde 
property=mal mülk
protest=protesto
proud=gururlu 
prove=kanıtlamak 
pull=çekmek 
punish=cezaya çarptırmak 
punishment=ceza
push=itelemek 
qualification=vasıf
qualified=nitelikli 
qualify=vasıflandırmak 
queue=kuyruğa girmek 
quit=bırakmak 
quotation=alıntı
quote=alıntı yapmak 
racing=yarışma
range=silsile
rare=ender 
rarely=nadiren 
reaction=tepkime
reality=gerçeklik
receipt=alındı
recommendation=tavsiye
reference=referans
reflect=aksettirmek 
regularly=düzenli olarak 
reject=geri çevirmek 
relate=nakletmek 
related=bağlantılı 
relation=ilişik
relative=hısım
relaxed=rahatlamış 
relaxing=dinlendirici 
release=piyasaya sunmak 
reliable=güvenilir 
religion=din
religious=dinsel 
remain=geriye kalmak 
remind=hatırlatmak 
remote=uzak
rent=kiralamak 
repair=tamir etmek 
repeat=yinelemek 
repeated=tekrarlanmış 
represent=temsil etmek 
request=rica etmek 
require=gerekmek 
reservation=yer ayırtma
resource=kaynak
respect=saygı göstermek 
responsibility=sorumluluk
responsible=mesul 
result=netice
retire=emekli olmak 
retired=emekli 
revise="gözden geçirerek düzeltmek
(metni) "
rise=doğmak 
risk=risk
robot=otomat
roll=yuvarlanmak 
romantic=duygusal 
rope=halat
rough=kaba saba 
row=sıra
royal=asil 
rugby=ragbi
rule=hüküm sürmek 
safety=emniyet
sail=denize açılmak 
sailor=gemici
sample=örnek
sand=kum
scan=taramak 
scientific=ilmi 
script=senaryo
sculpture=heykel
secondary=ikincil 
security=güvenlik
seed=tohum
sensible=mantıklı 
separate=ayırmak 
seriously=cidden 
servant=hizmetçi
set=kurmak 
setting=ortam
shake=sallanmak 
share=paylaşmak 
sharp=sivri 
shelf=raf
shell=kabuk
shift=değiştirmek 
shine=parıldamak 
shiny=parlak 
shoot=film çekmek 
shy=korkmak 
sight=görünüş
signal=sinyal vermek 
silent=suskun 
silly=saçma sapan 
similarity=benzerlik
similarly=aynı şekilde 
simply=basit bir şekilde 
since=ondan sonra 
sink=suya batmak 
slice=dilimlemek 
slightly=hafif tertip 
slow=yavaşlatmak 
smart=sızlamak 
smooth=düzlemek 
software=yazılım
soil=toprak
solid=sağlam 
sort=sıralamak 
southern=güneye ait 
specifically=belirli bir biçimde 
spending=harcama
spicy=baharatlı 
spirit=ispirto
spoken=sözlü 
spot=leke
spread=yaymak 
spring=memba
stadium=stadyum
staff=kadro
standard=standart 
state=ifade etmek 
statistic=istatistik
statue=heykel
stick=saplamak 
still=durgun 
store=depolamak 
stranger=yabancı
strength=güç
string=sicim
strongly=fazlasıyla 
studio=stüdyo
stuff=şey
substance=cisim
successfully=başarılı biçimde 
sudden=ani 
suffer=acı çekmek 
suit=uygun olmak 
suitable=münasip 
summarize=özetlemek 
summary=hülasa
supply=tedarik etmek 
supporter=taraftar
surely=muhakkak 
surface=yüzey
survive=uzun yaşamak (birinden) 
swim=yüzmek 
switch=değiştirmek 
symptom=belirti
tail=kuyruk
talent=kabiliyet
talented=yetenekli 
tape=kaset
tax=vergilendirmek 
technical=teknik 
technique=teknik
tend=eğilimi olmak 
tent=çadır
that=şu [zm.]
theirs=onlarınki [zm.]
theme=tema
theory=teori
therefore=bu sebeple 
this=bu [zm.]
though=gerçi [bağ.]
throat=boğaz
throughout=boyunca 
tight=sıkı 
till=-e kadar [ed.]
tin=teneke
tiny=mini mini 
tip=bahşiş
toe=ayak parmağı
tongue=dil
total=toplam
totally=bütünüyle 
touch=ellemek 
tour=gezmek 
trade=ticaret
translate=çevirmek 
translation=çeviri
transport=taşımak 
treat=davranmak 
treatment=muamele
trend=eğilim göstermek 
trick=oyuna getirmek 
truth=hakikat
tube=tüp
type=yazmak 
typically=sıklıkla 
tyre=tekerlek
ugly=çirkin 
unable=aciz 
uncomfortable=konforsuz 
underwear=iç çamaşırı
unemployed=işsiz 
unemployment=işsizlik
unfair=adil olmayan 
union=sendika
unless=mediği sürece [bağ.]
unlike=farklı 
unlikely=pek mümkün olmayan 
unnecessary=gereksiz 
unpleasant=hoşa gitmeyen 
update=güncelleştirmek 
upon=üzerine [ed.]
upset=keyfini kaçırmak 
used=kullanılmış 
valuable=değerli 
value=değer vermek 
various=çeşitli 
version=sürüm
victim=kurban
view=incelemek 
viewer=izleyici
violent=şiddetli 
volunteer=gönüllü
vote=oy vermek 
warm=ısıtmak 
warn=uyarmak 
warning=ihtar
waste=boşa harcamak 
water=sulamak 
wave=dalgalanmak 
weapon=silah
weigh=tartmak 
western=kovboy filmi
whatever=hangi 
whenever=herhangi bir zamanda 
whether=-ip -mediğini [bağ.]
while=sırasında [bağ.]
whole=tam 
will=vasiyet
win=kazanmak 
wing=kanat
within=dahilinde [ed.]
wonder=merak etmek 
wool=yün
worldwide=dünya çapındaki 
worry=endişelenmek 
worse=daha kötüsü
worst=yenmek 
worth=değer
written=yazılı 
wrong=yanlış 
yard=bahçe
young=genç
youth=gençlik

