abandon=terk etmek
absolute=tam 
absorb="almak(dikkati/enerjiyi/zamanı/parayı)"
abstract=soyutlamak
academic=akademik 
accent=şive 
acceptable=kabul edilir 
accidentally=kazara 
accommodate=yaşayacak yer temin etmek
accompany=eşlik etmek
accomplish=başarıyla tamamlamak
account=hesap 
accountant=muhasebeci 
accounting=muhasebe 
accuracy=doğruluk 
accurate=doğru 
accurately=kesin olarak 
accuse=suçlamak
acid=ekşime 
acknowledge=kabullenmek
acquire=elde etmek
activate=çalıştırmak
actual=aktüel 
adapt=adapte etmek
addiction=düşkünlük 
additional=fazladan 
additionally=bundan başka 
address=hitap etmek
adequate=yeterli 
adequately=layıkıyle 
adjust=ayarlamak
administration=yönetim 
adopt=evlat edinmek
advance=terfi ettirmek
affair=mesele 
affordable=bütçeye uygun 
afterwards=sonradan 
agency=acente 
agenda=gündem 
aggressive=agresif 
agriculture=ziraat 
AIDS=aids 
aid=yardım etmek
aircraft=uçak 
alarm=alarm 
alien=yabancı uyruklu kimse 
alongside=yanına 
alter=değiştirmek
altogether=hep beraber 
ambulance=ambulans 
amount=miktar 
amusing=eğlenceli 
analyst=çözümlemeci 
ancestor=ata 
anger=kızdırmak
angle=açı 
animation=çizgi film yapma 
anniversary=yıl dönümü 
annual=senelik 
annually=yılda bir 
anticipate=beklemek
anxiety=endişe 
anxious=endişeli 
apology=özür 
apparent=aşikar 
apparently=görünüşte 
appeal=başvurmak
applicant=aday 
approach=yanaşmak
appropriate=el koymak
appropriately=uygun olarak 
approval=tasvip 
approve=onaylamak
arise=arose - arisen
armed=ateşli 
arms=koyun 
arrow=ok 
artificial=yapma 
artistic=sanatçı ruhuna sahip 
artwork=sanat eseri 
ashamed=mahcup 
aside=bertaraf 
aspect=hal 
assess=değer biçmek
assessment=değerlendirme 
asset=varlık 
assign=devretmek
assistance=yardım 
associate=ilişkilendirmek
associated=birleşmiş 
association=birlik 
assume=üstlenmek
assumption=sanı 
assure="temin etmek (rahatlatıcı/ikna
edici sözlerle)"
astonishing=hayrette bırakan 
attachment=muhabbet 
attempt=teşebbüs etmek
auction=mezat 
audio=ses 
automatic=otomatik 
automatically=özdevimlice 
awareness=farkındalık 
awkward=beceriksiz 
back=art 
bacteria=bakteri 
badge=rozet 
balanced=dengeli 
ballet=bale 
balloon=balon 
bar=çubuk 
barely=ancak 
bargain=kelepir 
barrier=set 
basement=bodrum 
basically=temelde 
basket=sepet 
bat=yarasa 
battle=savaş 
bear=dayanmak
beat=vurmak
beg=dilenmek
being=yapı 
beneficial=yararlı 
bent=bükülmüş 
beside=yanında [ed.]
besides=ayrıca 
bet=iddiaya girmek
beyond=öte 
bias=önyargı 
bid=teklif etmek
bill=senet 
biological=yaşambilimsel 
bitter=acı 
blame=suçlamak
blanket=battaniye 
blind=kör 
blow=esmek
bold=gözüpek 
bombing=bombalı eylem 
bond=tutturmak
booking=rezervasyon 
boost=alttan yukarıya ittirmek
border=hudut 
bound=zıplaya zıplaya gitmek
breast=meme 
brick=tuğla 
brief=kısa 
briefly=kısaca 
broad=engin 
broadcast=yayın 
broadcaster=televizyoncu 
broadly=açık olarak 
budget=bütçe 
bug=böcek 
bullet=mermi 
bunch=salkım 
burn=yakmak
bush=çalı 
but=ancak [bağ.]
cabin=kabin 
cable=kablo 
calculate=hesap etmek
canal=kanal 
cancel=feshetmek
cancer=kanser 
candle=mum 
capable=yetenekli 
capacity=kapasite 
capture=esir almak
carbon=karbon 
cast=dökmek
casual=gündelik 
catch=enselemek
cave=mağara 
cell=hücre 
certainty=kesinlik 
certificate=sertifika 
chain=zincir 
chair=koltuk 
chairman=başkan (yönetim kurulu) 
challenge=düelloya davet etmek
challenging=dürtücü 
championship=şampiyona 
characteristic=özellik 
charming=cazibeli 
chart=çizelge 
chase=peşinde olmak
cheek=yanak 
cheer=neşelendirmek
chief=şef 
choir=koro 
chop=doğramak
circuit=çevrim 
circumstance=durum 
cite=aktarmak
citizen=vatandaş 
civil=sivil 
civilization=uygarlık 
clarify=berraklaşmak
classic=klasik 
classify=sınıflandırmak
cleaning=temizlik 
clerk=yazman 
cliff=uçurum 
clinic=klinik 
clip=kırkmak
close=kapamak
closely=yakından 
coincidence=rastlantı 
collapse=yığılmak
collector=toplaç 
colony=sömürge 
colourful=rengarenk 
combination=birleştirme 
comfort=rahatlık 
comic=komik 
command=emretmek
commander=komutan 
commission=komisyon 
commitment=bağlılık 
committee=kurul 
commonly=ortak olarak 
comparative=karşılaştırmalı 
completion=bitirme 
complex=karışık 
complicated=çetrefil 
component=bileşen 
compose=bestelemek
composer=yazar 
compound=şiddetlendirmek
comprehensive=etraflı 
comprise=kapsamak
compulsory=zorunlu 
concentration=yığma 
concept=konsept 
concern=ilgilendirmek
concerned=ilgili 
concrete=beton 
conduct=yönetmek
confess=itiraf etmek
confidence=güven 
conflict=çekişmek
confusing=şaşırtma 
confusion=karmaşa 
conscious=bilinçli 
consequently=sonuç olarak 
conservation=koruma 
conservative=muhafazakar 
considerable=hatırı sayılır derecede 
considerably=oldukça 
consideration=düşünce 
consistent=istikrarlı 
consistently=sürekli olarak 
conspiracy=komplo 
constant=sabit 
constantly=ikide bir 
construct=inşa etmek
construction=yapı 
consult=başvurmak
consultant=danışman 
consumption=tüketim 
contemporary=modern 
contest=yarışma 
contract=(hastalığa) yakalanmak
contribute=katkı yapmak
contribution=katkı 
controversial=çekişmeli 
controversy=ihtilaf 
convenience=kolaylık 
convention=düzen 
conventional=geleneksel 
convert=dönüştürmek
convey=iletmek
convinced=inandırılan 
convincing=inandırıcı 
cope=başa çıkmak
core=göbek 
corporate=şirkete ait 
corporation=kurum 
corridor=koridor 
council=meclis 
counter=tezgah 
county=ilçe 
courage=cesurluk 
coverage=kapsam 
crack=yarılmak
craft=esnaf 
crash=çarpışmak
creation=kreasyon 
creativity=yaratıcılık 
creature=varlık 
credit=kredi 
crew=tayfa 
crisis=bunalım 
criterion=kriter 
critic=eleştirmen 
critical=kritik 
critically=tehlikeli olarak 
criticism=tenkit 
criticize=eleştirmek
crop=mahsul 
crucial=çok önemli 
cruise=dolaşmak
cry=haykırmak
cue=işaret 
cure=iyileştirmek
curious=meraklı 
current=akım 
curriculum=müfredat 
curve=bükülmek
curved=eğimli 
cute=sevimli 
dairy=mandıra 
dare=cüret etmek
darkness=karanlık 
database=veritabanı
date=(biriyle) çıkmak
deadline=son teslim tarihi 
deadly=ölümcül 
dealer=bayi 
debate=çekişmek
debt=borç 
decent=edepli 
deck=deste 
declare=beyan etmek
decline=zayıflamak
decoration=süsleme 
decrease=küçülmek
deeply=son derece 
defeat=yenmek
defence=müdafaa 
defend=savunmak
defender=muhafız 
delay=gecikmek
delete=silmek
deliberate=kasti 
deliberately=kasten 
delight=haz 
delighted=memnun 
delivery=doğum 
demand=talep etmek
democracy=demokratlık 
democratic=demokratik partiye ait 
demonstrate=ispat etmek
demonstration=ispat 
deny=yalanlamak
depart=yola çıkmak
dependent=bağımlı 
deposit=emanet 
depressed=canı sıkkın 
depressing=bunaltıcı 
depression=çöküntü 
depth=derinlik 
derive=türemek
desert=terk etmek
deserve=hak etmek
desire=istek duymak
desperate=çaresiz 
desperately=umutsuzca 
destruction=tahribat 
detail=detay 
detailed=ayrıntılı 
detect=keşfetmek
determination=saptama 
devote=adamak
differ=ters düşmek
dig=kazmak
disability=malullük 
disabled=sakat 
disagreement=anlaşmazlık 
disappoint=hayal kırıklığına uğratmak
disappointment=hüsran 
disc=disk 
discipline=disiplin 
discount=tenzilat 
discourage=cesaretini kırmak
dishonest=namussuz 
dismiss=azletmek
disorder=kargaşa 
display=sergilemek
distant=uzakta 
distinct=belirgin 
distinguish=ayırmak
distract=dikkatini dağıtmak
distribute=dağıtmak
distribution=dağıtma 
district=semt 
disturb=rahatsız etmek
dive=dalmak
diverse=çeşit çeşit 
diversity=çeşitlilik 
divide=bölmek
division=bölme 
divorce=boşanmak
document=doküman 
domestic=iç 
dominant=baskın 
dominate=hükmetmek
donation=bağış 
dot=nokta 
downtown=çarşı 
downwards=aşağıya doğru 
dozen=çok sayı 
draft=tasarı 
drag=sürüklemek
dramatic=dramatik 
dramatically=dramatik bir biçimde 
drought=kuraklık 
dull=donuk 
dump=çöplük 
duration=müddet 
dynamic=hareketli 
economics=ülke ekonomisi 
economist=ekonomist 
edit=düzenlemek
edition=yayım 
editorial=başmakale 
efficient=etkili 
efficiently=yeterli olarak 
elbow=dirsek 
elderly=yaşlı 
elect=seçmek
electronics=elektronik bilimi 
elegant=şık 
elementary=başlayanlar için 
eliminate=elemek
elsewhere=başka yere 
embrace=kucaklamak
emerge=yücelmek
emission=emisyon 
emotional=dokunaklı 
emotionally=heyecanla 
emphasis=vurgu 
emphasize=vurgulamak
empire=imparatorluk 
enable=olanak vermek
encounter=rastlamak
engage=angaje etmek
enhance=arttırmak
enjoyable=zevkli 
enquiry=sorgu 
ensure=sağlama almak
entertaining=eğlendirici 
enthusiasm=heves 
enthusiastic=coşkulu 
entire=bütün 
entirely=tümüyle 
entrepreneur=müteşebbis 
envelope=zarf 
equal=denk 
equip=donatmak
equivalent=eşdeğer 
era=dönem 
erupt=patlak vermek
essentially=özünde 
establish=kanıtlamak
estate=emlak 
estimate=kestirmek
ethic=ahlak sistemi 
ethical=ahlaka uygun 
ethnic=etnik 
evaluate=değerlendirmek
evaluation=değerlendirme 
even=düzgün 
evident=belli 
evil=fenalık 
evolution=evrim 
evolve=evrim geçirmek
examination=inceleme 
exceed=sınırı aşmak
exception=istisna 
excessive=haddinden fazla 
exclude=dışlamak
excuse=mazur görmek
executive=yönetici 
exhibit=sergilemek
existence=mevcudiyet 
exit=çıkmak
exotic=egzotik 
expansion=genleşme 
expectation=beklenti 
expense=masraf 
expertise=uzman görüşü sunmak
exploit=kendi çıkarı için kullanmak
exploration=keşif 
expose=maruz bırakmak
exposure=teşhir 
extend=sunmak (taziye/kutlama)
extension=uzatma 
extensive=yaygın 
extensively=uzatılmış olarak 
extent=boyut 
external=dış 
extract=özünü çıkarmak
extraordinary=fevkalade 
extreme=aşırı 
fabric=kumaş 
fabulous=efsanevi 
facility=tesis 
failed=arızalı
failure=yapmama 
faith=güven 
fake=sahte 
fame=nam 
fantasy=fantezi 
fare=başından geçmek
fault=fay 
favour=iyilik etmek
feather=kuş tüyü 
federal=federal 
fee=harç 
feed=beslemek
feedback=geri bildirim 
feel=hissetmek
fellow=herif 
fever=ateş 
figure=rakam 
file=eğe 
finance=finanse etmek
finding=bulma 
firefighter=itfaiyeci 
firework=havai fişek 
firm=firma 
firmly=dümdüz 
fix=düzeltmek
flame=alev 
flash=ışık tutmak
flavour=tat 
flexible=bükülgen 
float=batmadan yüzmek
fold=bükülmek
folding=kıvrım 
following=taraftarlar 
fond=düşkün 
fool=kandırmak
forbid=yasaklamak
forecast=tahmin etmek
forgive=affetmek
format=format atmak
formation=oluşum 
former=önceki 
formerly=vaktiyle 
fortunate=akgünlü 
fortune=talih 
forum=toplantı 
forward=ileri 
fossil=taşlaşmak
found=kurmak
foundation=dayanak 
founder=kurucu 
fraction=fraksiyon 
fragment=fragman 
framework=kadro 
fraud=sahtekarlık 
free=bağımsız 
freedom=bağımsızlık 
freely=serbestçe 
frequency=sıklık 
frequent=sık 
fuel=yakıt 
fulfil=yerine getirmek
full-time=tamgün 
fully=tamamıyla 
function=işlev 
fund=kaynak 
fundamental=esas 
fundamentally=esasen 
funding=fonlama 
furious=çok öfkeli 
furthermore=üstelik 
gain=kazanmak
gaming=kumar 
gang=çete 
gender=cins 
gene=gen 
generate=meydana getirmek
genetic=genetik yapı 
genius=dahi 
genre=tür 
genuine=özgün 
genuinely=gerçekten 
gesture=el/kol/baş hareketi yapmak
gig=zıpkın ile balık yakalamak
globalization=globalleşme 
globe=küre 
golden=altın 
goodness=iyilik 
gorgeous=muhteşem 
govern=kontrol etmek
governor=vali 
grab=kapmak
grade=puanlamak
gradually=yavaş yavaş 
grand=büyük 
grant=bağışlamak
graphic=grafik 
graphics=grafik sanatlar 
greatly=çok 
greenhouse=sera 
grocery=bakkaliye 
guarantee=güvence 
guideline=hakim 
habitat=bitkilerin doğal yetiştiği yer 
handle=idare etmek
harbour=barındırmak
harm=zarar 
harmful=zararlı 
headquarters=merkez 
heal=şifa bulmak
healthcare=sağlık hizmeti
hearing=duruşma 
heaven=cennet 
heel=topuk 
hell=cehennem 
helmet=miğfer 
hence=buradan 
herb=ot 
hesitate=duraksamak
hidden=gizli 
high=yüksek 
highway=otoban 
hilarious=gürültülü ve neşeli 
hip=kalça 
hire=kiralamak
historian=tarihçi 
hold=sahip olmak
hollow=oyuk 
holy=kutsal 
homeless=evsiz 
honesty=dürüstlük 
honour=şereflendirmek
hook=kanca 
hopefully=ümitle 
host=ağırlamak
house=ev 
household=ev veya aileye ait 
housing=konut 
humorous=güldürücü 
humour=mizah 
hunger=açlık 
hunt=avlanmak
hunting=avlama 
hurt=acımak
hypothesis=hipotez 
icon=ikona 
ideal=ülkü 
identical=özdeş 
illusion=kuruntu 
illustrate=örneklerle açıklamak
illustration=örnekleme 
imagination=hayal gücü 
immigration=göç 
immune=bağışık 
impatient=sabırsız 
implement=yerine getirmek (plan vb'ni)
implication="(bir kimseyi olumsuz bir şeye)
karıştırma/bulaştırma "
imply=ima etmek
impose=(yasa vb) uygulamaya koymak
impress=iz bırakmak
impressed=etkilenmiş 
incentive=teşvik 
inch=yavaş yavaş hareket etmek
incident=hadise 
income=gelir 
incorporate=firma kurmak
incorrect=yanlış 
increasingly=gitgide artarak 
independence=özgürlük 
index=indekslemek
indication=belirti 
industrial=endüstri 
inevitable=kaçınılmaz 
infection=enfeksiyon 
infer=anlam çıkarmak
inflation=enflasyon 
info=haber 
inform=bilgilendirmek
infrastructure=altyapı 
inhabitant=ikamet eden 
inherit=miras olarak almak
initial=ilk harf 
initially=başlangıçta 
initiative=girişkenlik 
ink=mürekkeplemek
inner=iç 
innovation=yenilik 
innovative=yaratıcı 
input=giriş 
insert=arasına sokmak
insight=içyüzünü anlama 
insist=ısrar etmek
inspector=müfettiş 
inspire=ilham vermek
install=kurmak
installation=montaj 
instance=misal 
instant=anlık 
instantly=hemen 
institute=enstitü 
institution=enstitü 
insurance=sigorta 
integrate=entegre etmek
intellectual=düşünsel 
intended=planlanan 
intense=yoğun 
interact=etkileşmek
interaction=etkileşim 
internal=dahili 
interpret=yorumlamak
interpretation=yorum 
interrupt=sekte vurmak
interval=ara 
invade=istila etmek
invasion=istila 
investigation=soruşturma 
investment=yatırım 
investor=sermayeci 
isolate=soyutlamak
isolated=izole 
issue=(dergi/gazete) nüsha 
jail=hapishane 
jet=jet uçağı ile uçmak
joint=eklem 
journalism=gazetecilik 
joy=keyif 
judgement=yargı 
junior=iki kişiden küçük olanı 
jury=jüri 
justice=adalet 
justify=savunmak
kit=pılı pırtı 
labour=uğraşmak
ladder=merdiven 
landing=inme 
landscape=manzara 
lane=(yol) şerit 
largely=büyük bir ölçüde 
lately=son zamanlarda 
latest=son 
launch=başlatmak (yeni işi)
leadership=önderlik 
leaflet=broşür 
league=lig 
lean=dayanmak
leave=bırakmak
legend=efsane 
lens=mercek 
level=seviye 
licence=lisans 
lifetime=ömür 
lighting=yakma 
likewise=aynı biçimde 
limitation=kısıtlama 
limited=kısıtlı 
line=astarlamak
literally=kelime kelime 
literary=edebi 
litre=litre 
litter="hayvanları yatırmak için serilen
saman veya kuru ot"
lively=canlı 
load=yüklemek
loan=ödünç para 
logical=mantıklı (kimse) 
logo=logo 
long-term=uzun vadeli 
loose=oynak 
lord=lord payesi vermek
lottery=piyango 
low=alçak 
lower=düşürmek
loyal=vefalı 
lung=akciğer 
lyric=gazel 
magnificent=fevkalade 
maintain=sürdürmek
majority=çoğunluk 
make=yapmak
make-up=yapım 
making=yapma 
manufacture=imal etmek
manufacturing=imalat 
map=harita 
marathon=maraton 
margin=marj 
marker=işaret 
martial=savaşa özgü 
mass=yığmak
massive=cüsseli 
master=efendi 
matching=karşılaştırma 
mate=mat 
material=materyal 
maximum=maksimum 
mayor=belediye başkanı 
means=araç 
measurement=ölçüm 
mechanic=tamirci 
mechanical=makineye ait 
mechanism=yöntem 
medal=nişan 
medication=ilaç 
medium=orta 
melt=eritmek
membership=üyelik 
memorable=hatırlanmaya değer 
metaphor=metafor 
military=askeri 
miner=madenci 
mineral=maden 
minimum=asgari 
minister=bakan 
minor=rüştünü ispat etmemiş kimse 
minority=azınlık 
miserable=acınası 
mission=vazife 
mistake=yanılgı 
mixed=karma 
mode=kip 
model=model 
modest=mütevazı 
modify=tamlamak
monitor=izlemek
monster=gaddar adam 
monthly=aylık 
monument=abide 
moral=ahlaki 
moreover=dahası 
mortgage=ipotek 
mosque=mescit 
motion=devinim 
motivate=motive etmek
motivation=motivasyon 
motor=motor 
mount=binmek
moving=hareketli 
multiple=multipl 
multiply=yayılmak
mysterious=esrarengiz 
myth=efsane 
naked=çıplak 
narrow=dar 
nasty=pis 
national=ulusal 
navigation=navigasyon 
nearby=yakında 
neat=düzenli 
necessity=gereklilik 
negative=negatif 
negotiate=görüşmek
negotiation=müzakere 
nerve=sinir 
neutral=tarafsız 
nevertheless=yine de 
newly=yeni 
nightmare=kabus 
norm=kaide 
notebook=defter 
notion=düşünce 
novelist=romancı 
nowadays=bu günlerde 
numerous=sayısız 
nursing=bakma 
nutrition=beslenme 
obesity=şişmanlık 
obey=itaat etmek
object=itiraz etmek
objective=hedef 
obligation=yükümlülük 
observation=gözetleme 
observe=gözlemlemek
observer=gözlemci 
obstacle=mani 
obtain=edinmek
occasionally=ara sıra 
occupation=uğraş 
occupy=işgal etmek
offence=darılmak
offend=rencide etmek
offender=fail 
offensive=saldıran 
official=memur 
ongoing=süregiden 
opening=açma 
openly=açıkça 
opera=opera 
operate=ameliyat etmek
operator=çalıştıran kişi 
opponent=rakip 
oppose=karşı koymak
opposed=karşıt 
opposition=aykırılık 
optimistic=iyimser 
orchestra=orkestra 
organ=organ 
organic=bedensel 
origin=menşe 
otherwise=aksi halde 
outcome=netice 
outer=dış 
outfit=donatmak
outline=taslağını çizmek
output="output/outputted -
output/outputted"
outstanding=üstün 
overall=bir uçtan bir uca 
overcome=üstesinden gelmek
overnight=gecelemek
overseas="denizlerin ötesinde bulunan ülke
vb "
owe=borçlu olmak
ownership=mülkiyet 
oxygen=oksitlenme 
pace=adımlamak
package=paketlemek
packet=paket 
palm=palmiye 
panel=pano 
panic=panik yapmak
parade=geçit töreni 
parallel=aynı doğrultuda olan 
parliament=meclis 
participant=katılımcı 
participation=katılım 
partly=kısmen 
partnership=ortaklık 
part-time=yarımgün 
passage=pasaj 
passionate=tutkulu 
password=şifre 
patience=sabır 
patient=hasta 
pause=duraklamak
peer=eş 
penalty=ceza 
pension=emekli maaşı 
perceive=algılamak
perception=algı 
permanent=daimi 
permanently=kalıcı bir şekilde 
permit=izin vermek
perspective=bakış açısı 
phase=aşama 
phenomenon=algılanabilen şey 
philosophy=felsefe 
pick=seçmek
picture=resim 
pile=yığın 
pill=sıkıcı tip 
pitch=yalpalamak
pity=acımak
placement=atama 
plain=ova 
plot=komplo kurmak
plus=artı 
pointed=sivri 
popularity=rağbet 
portion=ayırmak
pose=(tehlike/tehdit) teşkil etmek
position=mevki 
positive=pozitif 
possess=sahip olmak
potential=potansiyel 
potentially=imkan dahilinde 
power=yetki 
praise=methetmek
precede=önce olmak
precious=değerli 
precise=kesin 
precisely=açık olarak 
predictable=önceden kestirilebilir 
preference=tercih 
pregnant=gebe 
preparation=hazırlık 
presence=mevcudiyet 
preserve=muhafaza etmek
price=bedel 
pride=gurur 
primarily=öncelikle 
prime=astar vurmak
principal=okul müdürü 
principle=prensip 
print=yazdırmak
prior=önceden 
priority=öncelik 
privacy=mahremiyet 
probability=olasılık 
probable=olası 
procedure=prosedür 
proceed=ilerlemek
process=işlemek
produce=üretmek
professional=profesyonel 
programming=programlama 
progress=gelişmek
progressive=ileri düşünceli kimse 
prohibit=önlemek
project=proje 
promising=geleceği parlak 
promotion=promosyon 
prompt=çabuk 
proof=kanıt 
proportion=orantı 
proposal=öneri 
propose=önermek
prospect=olasılık 
protection=himaye 
protein=protein 
protester=protestocu 
psychological=ruhbilimsel 
psychologist=tinbilimci 
psychology=ruh bilimi 
publication=yayınlama 
publicity=tanıtım 
publishing=yayıncılık 
punk=aşağılamak
pupil=öğrenci 
purchase=satın almak
pure=saf 
purely=sırf 
pursue=izlemek
pursuit=kovalama 
puzzle=bulmaca 
questionnaire=anket 
racial=ırksal 
racism=anasoyculuk 
racist=ırkçı 
radiation=ışınım 
rail=ray döşemek
random=gelişigüzel 
range=silsile 
rank=rütbe 
rapid=ani 
rapidly=hızla 
rat=sıçan 
rate=kur 
rating=derece 
raw=çiğ 
reach=ulaşmak
realistic="ideal ya da ahlaki boyutundan
ziyade faydacı ve pratik yönü ağır
basan "
reasonable=makul 
reasonably=orta derecede 
rebuild=yeniden inşa etmek
recall=hatırlamak
receiver=alıcı 
recession=girinti 
reckon=tahmin etmek
recognition=tanıma 
recover=kurtarmak
recovery=kurtulma 
recruit=iyileştirmek
recruitment=işe alım 
reduction=indirme 
referee=hakem 
refugee=mülteci 
regard=saymak
regional=bölgesel 
register=kaydetmek
registration=tescil 
regret=pişman olmak
regulate=düzenlemek
regulation=düzenleme 
reinforce=pekiştirmek
relatively=nispeten 
relevant=konuyla ilgili 
relief=rahatlama 
relieve=rahatlatmak
relieved=rahatlamış 
rely=güvenmek
remark=belirtmek
remarkable=dikkat çekici 
remarkably=dikkat çekecek derecede 
reporting=raporlama 
representative=temsil eden 
reputation=ün 
requirement=ihtiyaç 
rescue=kurtarmak
reserve=rezerve ettirmek
resident=sakin 
resign=istifa etmek
resist=direnmek
resolution=kararlılık 
resolve=kesin karar vermek
resort=tatil yeri 
restore=yenileştirmek
restrict=sınırlamak
restriction=sınırlama 
retail=perakende satış 
retain=sürdürmek
retirement=emeklilik 
reveal=meydana çıkarmak
revenue=hasılat 
revision=gözden geçirme 
revolution=ihtilal 
reward=ödüllendirmek
rhythm=ritim 
rid=rid - rid
ridiculous=gülünç 
risky=riskli 
rival=rakip 
rob=soymak
robbery=hırsızlık 
rocket=roket 
romance=romantizm 
root=köken 
rose=gül 
roughly=yaklaşık olarak 
round=yuvarlak 
routine=rutin 
rub=sürtmek
rubber=kauçuk 
ruin=mahvetmek
rural=kırsal 
rush=acele etmek
sample=örnek 
satellite=uydu 
satisfaction=memnuniyet 
satisfied=memnun 
satisfy=tatmin etmek
saving=tasarruf 
scale=ölçeklendirmek
scandal=skandal 
scare=ürkütmek
scenario=senaryo 
schedule=plan 
scheme=fesat karıştırmak
scholar=bilgin 
scholarship=burs 
scratch=kazımak
scream=bağırmak
screen=ekran 
screening=görüntüleme 
seat=oturtmak
sector=sektör 
secure=sağlamlaştırmak
seek=aramak
seeker=sonda 
select=seçmek
selection=seçme 
self=öz 
seminar=seminer 
senior=kıdemli 
sense=algılamak
sensitive=içli 
sentence=cümle 
sequence=silsile 
session=celse 
settle=yerleşmek
settler=göçmen 
severe=haşin 
severely=ağır 
shade=gölge 
shadow=gölge 
shallow=sığ 
shame=utandırmak
shape=şekillendirmek
shaped=şekillendirilmiş 
shelter=barınak 
shift=değiştirmek
ship=gemi 
shock=şok etmek
shocked=çarpılmış 
shocking=şok edici 
shooting=ateş etme 
shore=sahil 
shortage=sıkıntı 
shortly=kısaca 
short-term=kısa süreli 
shot=atış 
sibling=kardeş 
signature=imza 
significance=önem 
significant=dikkate değer 
significantly=önemli ölçüde 
silence=susturmak
silk=ipek 
sincere=içten 
skilled=yetenekli 
skull=kafatası 
slave=köle gibi çalışmak
slide=sürgü 
slight=hafif 
slip=kaymak
slogan=slogan 
slope=meyil 
so-called=sözde 
solar=güneş 
somehow=iyi kötü 
sometime=sabık 
somewhat=birazcık 
sophisticated=sofistike 
soul=ruh 
spare=kıymamak
specialist=uzman 
specialize=uzmanlaşmak
species=tür 
specify=belirlemek
spectacular=muhteşem 
spectator=seyirci 
speculate=tahminde bulunmak
speculation=tahmin 
speed=sürat 
spill=dökmek
spiritual=ruhsal 
spite=rahatsız etmek
split=yarmak
spoil=şımartmak
spokesman=sözcü 
spokesperson=konuşmacı 
spokeswoman=konuşmacı bayan 
sponsor=kefil olmak
sponsorship=destek 
sporting=spor 
spot=leke 
spread=yaymak
stable=ahır 
stage=sahneye koymak
stall=stop ettirmek
stance=duruş 
stand=(teklif) geçerli olmak
stare=dik dik bakmak
starve=açlıktan ölmek
status=hal 
steadily=durmadan 
steady=sabit durum 
steam=istim 
steel=çelik 
steep=dik 
step=üvey 
sticky=yapış yapış 
stiff=çetin 
stimulate=uyarmak
stock=stoklamak
stream=dere 
strengthen=sağlamlaştırmak
stretch=uzatmak
strict=sıkı 
strictly=açıkçası 
strike=çarpmak
stroke=felç 
structure=yapılandırmak
struggle=çabalamak
stuff=şey 
stunning=sersemletme 
subject=ders 
submit=sunmak
subsequent=sonradan gelen 
subsequently=sonra 
suburb=varoş 
suffering=mihnet 
sufficient=kafi 
sufficiently=yeteri kadar 
sum=toplam 
super=süper 
surgeon=cerrah 
surgery=ameliyat 
surround=kuşatmak
surrounding=çevre 
survey=araştırma 
survival=hayatta kalma 
survivor=hayatta kalan 
suspect=şüphelenmek
suspend=askıya almak
sustainable=güçlendirilebilir 
swallow=yutmak
swear=sövmek
sweep=süpürmek
switch=değiştirmek
sympathetic="birinin duygularını anlayıp
paylaşan "
sympathy=sempati 
tackle=ele almak (bir problemi)
tag=etiketlemek
tale=masal 
tank=tank 
tap=hafifçe vurmak
target=hedef 
tear=yırtılmak
technological=teknolojik 
teens=yeniyetmelik 
temple=tapınak 
temporarily=geçici olarak 
temporary=geçici 
tendency=eğilim 
tension=tansiyon 
term=isimlendirmek
terminal=terminal 
terms=ara 
terribly=son derece 
terrify=çok korkutmak
territory=yöre 
terror=terör 
terrorism=terörism 
terrorist=terörist 
testing=deneme 
textbook=ders kitabı 
theft=hırsızlık 
therapist=terapist 
therapy=iyileştirme 
thesis=tez 
thorough=derin 
thoroughly=adamakıllı 
threat=tehdit 
threaten=tehdit etmek
thumb=parmağıyla çevirmek (sayfa)
thus=böylelikle 
time=kez 
timing=saat tutma 
tissue=doku 
title=unvan 
ton=moda 
tone=ton 
tonne=ton 
tough=zorlu 
tournament=turnuva 
trace=iz sürmek
track=izlemek (iz vb)
trading=ticaret 
tragedy=fecaat 
tragic=acıklı 
trait=haslet 
transfer=nakletmek
transform=dönüşmek
transition=geçiş 
transmit=iletmek
transportation=taşıma 
trap=kapan 
treasure=hazine 
trial=yargılama 
tribe=oymak 
trigger=tetiklemek
trillion=trilyon 
trip=seyahat 
troop=topluca ilerlemek
tropical=tropikal 
trouble=sorun 
truly=tamamen 
trust=güvenmek
try=denemek
tsunami="denizaltı depremlerinin ortaya
çıkardığı büyük dalga "
tune=akort etmek
tunnel=tünel 
ultimate=nihai 
ultimately=sonunda 
unacceptable=kabul edilemez 
uncertainty=belirsizlik 
unconscious=kendinden geçmiş 
undergo=geçirmek (hastalık)
undertake=yüklenmek
unexpected=beklenmedik 
unfold=(katlanmış bir seyi) açmak
unfortunate=şanssız 
unique=emsalsiz 
unite=birleşmek
unity=birlik 
universal=üniversal 
universe=alem 
unknown=bilinmez 
upper=üst 
upwards=yukarıya 
urban=şehirsel 
urge=dürtü 
urgent=ivedi 
usage=kullanım 
useless=işe yaramaz 
valid=geçerli 
value=değer vermek
variation=varyasyon 
vary=keşikleşmek
vast=büyüklük 
venue=olayın gerçekleştiği yer 
vertical=dik 
very=çok 
via=vasıtasıyla [ed.]
victory=utku 
viewpoint=bakış açısı 
violence=şiddet 
virtual=sanal 
visa=vize 
visible=görünür 
vision=görme 
visual=görsel 
vital=yaşamsal 
vitamin=vitamin 
volume=hacim 
voluntary=gönüllü 
voting=oylama 
wage=maaş 
wander=başıboş dolaşmak
warming=dayak atma 
way=yol 
weakness=kuvvetsizlik 
wealth=varlık 
wealthy=varlıklı 
weekly=haftalık 
weird=acayip 
welfare=gönenç 
wheat=buğday 
whereas=oysaki [bağ.]
wherever=nerede 
whilst=iken
whisper=fısıldamak
whoever=her kim [zm.]
whom=kime [zm.]
widely=genişce 
widespread=yaygın 
wildlife=yaban hayatı 
willing=hevesli 
wind=sarmak
wire=telle bağlamak
wisdom=akıl 
wise=bilge 
withdraw=geri çekilmek
witness=şahit olmak
workforce=iş gücü 
workplace=işyeri 
workshop=çalıştay 
worm="solucan gibi kıvrılarak ilerlemek"
worse=daha kötüsü 
worst=yenmek
worth=değer 
wound=yaralamak
wrap=sarmak
wrist=krank pimi 
wrong=yanlış 
yet=henüz 
zone=kuşak 
