abolish =feshetmek 
abortion=bebek aldırma 
absence=bulunmayış 
absent=hazır bulunmayan
absurd=absürt
abundance=çokluk 
abuse=suistimal etmek 
academy=akademi 
accelerate=hızlanmak 
acceptance=kabul 
accessible=ulaşılabilir
accomplishment=başarma 
accordance=uygunluk 
accordingly=dolayısıyla 
accountability=sorumluluk 
accountable=mesul
accumulate=biriktirmek 
accumulation=birikim 
accusation=itham 
accused=zanlı 
acid=ekşime 
acquisition=kazanma 
acre=arazi 
activation=etkinleşme 
activist=etkinci 
acute=şiddetli
adaptation=intibak 
adhere=yapışmak 
adjacent=komşu
adjustment=ayarlama 
administer=yönetmek 
administrative=idari
administrator=yönetici 
admission=itiraf 
adolescent=ergen
adoption=benimseme 
adverse=olumsuz
advocate=avukat 
aesthetic=güzelduyu 
affection=alaka 
aftermath=akıbet 
aggression=saldırganlık 
agricultural=tarım
aide=buyruk kulu 
albeit=yine [bağ.]
alert=alarma geçirmek 
alien=yabancı uyruklu kimse 
align=sıralanmak 
alignment=sıra 
alike=benzeyen
allegation=iddia 
allege=iddia etmek 
allegedly=iddia edildiğine göre 
alliance=antlaşma 
allocate=tahsis etmek 
allocation=paylaştırma 
allowance=izin 
ally=müttefik ülke 
aluminium=alüminyum
amateur=amatör
ambassador=elçi 
amend=düzeltmek 
amendment=yasayı değiştirme 
amid=arasında 
analogy=mukayese 
anchor=demir atmak 
angel=melek 
anonymous=anonim
apparatus=levazım 
appealing=isteme 
appetite=iştah 
applaud=alkışlamak 
applicable=uygulanabilir
appoint=atamak 
appreciation=takdir 
arbitrary=keyfi
architectural=mimarlığa ait
archive=belgelik 
arena=arena 
arguably=muhtemelen 
arm=kol 
array=sıralamak 
articulate=söylemek 
ash=kül 
aspiration="büyük amaç (uzun zamandır güdülen) "
aspire=heveslenmek 
assassination=suikast 
assault=saldırmak 
assemble=toplaşmak 
assembly=toplantı 
assert=öne sürmek 
assertion=sav 
assurance=güvence 
asylum=barınak 
atrocity=berbatlık 
attain=elde etmek 
attendance=katılma 
attorney=dava vekili 
attribute=bağlamak 
audit=hesapları denetlemek 
authentic=özgün
authorize=yetki vermek 
auto=otomobil 
autonomy=özerklik 
availability=geçerlilik 
await=gözlemek 
backdrop=arka fon eklemek 
backing=yardım 
backup=yedeğini almak 
bail=kefaletle serbest bırakmak 
ballot=oy vermek 
banner=pankart 
bare=çıkarmak 
barrel=varil 
bass=bas 
bat=yarasa 
battlefield=harp meydanı 
bay=defne 
beam=ışın 
beast=hayvan 
behalf=biri adına 
beloved=sevgili
bench=sıra 
benchmark=röper 
beneath=altında 
beneficiary=lehtar 
betray=ihanet etmek 
bind=ciltlemek 
biography=yaşam öyküsü 
bishop=piskopos 
bizarre=garip
blade=bıçak ağzı 
blast=büyük patlama 
bleed=bled - bled 
blend=karıştırmak 
bless=kutsamak 
blessing=nimet 
boast=övünmek 
bonus=sürpriz 
boom=gümlemek 
bounce=sektirmek 
boundary=sınır 
bow=yay 
breach=uymama 
breakdown=bozulma 
breakthrough=ilerleme 
breed=doğurmak 
broadband=genişbant
browser=listeleyici 
brutal=vahşi
buck=sıçramak 
buddy=ahbap 
buffer=tampon 
bulk=büyütmek 
burden=sırtına yüklemek 
bureaucracy=bürokrasi 
burial=gömme 
burst=patlamak 
cabinet=dolap 
calculation=hesaplama 
canvas=tuval 
capability=kabiliyet 
capitalism=sermayecilik 
capitalist=sermayedar 
cargo=kargo 
carriage=taşımacılık 
carve=oymak 
casino=kumarhane 
casualty=kazazede 
catalogue=katalog 
cater=temin etmek 
cattle=sığır 
caution=ihtiyat 
cautious=ihtiyatlı
cease=son vermek 
cemetery=mezarlık 
chamber=oda 
chaos=karmaşa 
characterize=nitelendirmek 
charm=cazibe 
charter=berat vermek 
chronic=kronik
chunk=yığın 
circulate=deveran etmek 
circulation=sürüm 
citizenship=yurttaşlık 
civic=şehir ile ilgili
civilian=sivil
clarity=berraklık 
clash=çarpışmak 
classification=sınıflandırma 
cling=tutunmak 
clinical=klinik
closure=kapanma 
cluster=küme 
coalition=birleşme 
coastal=sahil
cognitive=bilişsel
coincide=kesişmek 
collaborate=işbirliği yapmak 
collaboration=işbirliği 
collective=toplu
collision=çarpışma 
colonial=sömürge
columnist=köşe yazarı 
combat=muharebe 
commence=başlatmak 
commentary=yorum 
commentator=yorumcu 
commerce=ticaret 
commissioner=delege 
commodity=emtia 
communist=solcu 
companion=refakatçi 
comparable=kıyaslanabilir
compassion=merhamet 
compel=zorlamak 
compelling=zorlu
compensate=tazmin etmek 
compensation=tazminat 
competence=yeterlik 
competent=ehil
compile=derlemek 
complement=tamamlamak 
complexity=karmaşa 
compliance=riayet 
complication=zorluk 
comply=boyun eğmek 
composition=kompozisyon 
compromise=anlaşmak 
compute=hesaplamak 
conceal=gizlemek 
concede=kabullenmek 
conceive=tasarlamak 
conception=düşünce 
concession=imtiyaz 
condemn=mahkum etmek 
confer=müzakere etmek 
confession=günah çıkarma 
configuration=biçim 
confine=sınırlandırmak 
confirmation=onay 
confront=yüzleştirmek 
confrontation=yüzleştirme 
congratulate=tebrik etmek 
congregation=cemaat 
congressional=kongresel
conquer=fethetmek 
conscience=vicdan 
consciousness=bilinç 
consecutive=ardışık
consensus=fikir birliği 
consent=razı olmak 
conserve=korumak 
consistency=tutarlılık 
consolidate=sağlamlaştırmak 
constituency="bir seçim bölgesindeki
seçmenler "
constitute=oluşturmak 
constitution=anayasa 
constitutional=anayasal
constraint=kısıtlama 
consultation=danışma 
contemplate=düşünüp taşınmak 
contempt=aşağılama 
contend=uğraşmak 
contender=çekişen 
content=içerik 
contention=yarışma 
continually=hiç durmadan 
contractor=müteahhit 
contradiction=tezat 
contrary=aksi
contributor="yazı yazan kimse (gazete/dergi vb) "
conversion=dönüşüm 
convict=suçlu bulmak 
conviction=inanç 
cooperate=işbirliği yapmak 
cooperative=kooperatif 
coordinate=koordine etmek 
coordination=koordinasyon 
coordinator=eşgüdümcü 
cop=polis memuru 
copper=bakır 
copyright=telif hakkı 
correction=düzeltme 
correlate=ilişkilendirmek 
correlation=korelasyon 
correspond=tekabül etmek 
correspondence=yazışma 
correspondent=eş 
corresponding=yerini tutan
corrupt=yozlaşmış
corruption=yolsuzluk 
costly=masraflı
councillor=meclis üyesi 
counselling=danışma 
counsellor=elçiden sonraki diplomat 
counter=tezgah 
counterpart=mevkidaş 
countless=sayısız
coup=uğurlu bir hareket 
courtesy=kibarlık 
craft=esnaf 
crawl=sürünmek 
creator=yaratıcı 
credibility=güvenirlik 
credible=inandırıcı
creep=sürünmek 
critique=eleştirmek 
crown=taç 
crude=ham
crush=ezmek 
crystal=billur 
cult=tarikat 
cultivate=ekip biçmek 
curiosity=merak 
custody=gözaltı 
cutting=kesim 
cynical=kinik
dam=baraj 
damaging=zarar verici
dawn=şafak 
debris=moloz 
debut="(müzisyen vb) ilk defa halkın karşısına çıkmak "
decision-making=karar verme 
decisive=kararlı
declaration=beyanname 
dedicated=özel
dedication=adama 
deed=tapu 
deem=tutmak 
default="yükümlülüğünü yerine
getirmemek "
defect=bozukluk 
defensive=savunan
deficiency=eksiklik 
deficit=açık (hesaplarda)
defy=küçümsemek 
delegate=temsilci 
delegation=delege atama 
delicate=narin
demon=iblis 
denial=reddetme 
denounce=ihbar etmek 
dense=yoğun
density=yoğunluk 
dependence=bağımlılık 
depict=anlatmak 
deploy=açmak 
deployment=konuşlanma 
deposit=emanet 
deprive=mahrum etmek 
deputy=milletvekili 
descend=inmek 
descent=düşme 
designate=atamak 
desirable=makbul
desktop=masa üstü
destructive=yıkıcı
detain=alıkoymak 
detection=buluş 
detention=engellenme 
deteriorate=bozulmak (sağlık/durum vb) 
devastate=harap etmek 
devil=iblis 
devise=icat etmek 
diagnose=teşhis etmek 
diagnosis=teşhis 
dictate=dikte etmek 
dictator=diktatör 
differentiate=farklılaştırmak 
dignity=itibar 
dilemma=açmaz 
dimension=boyut 
diminish=azalmak 
dip=(sıvı içine) batma 
diplomat=diplomat 
diplomatic=diplomatik
directory=rehber 
disastrous=feci
discard=ıskartaya çıkarmak 
discharge=taburcu etmek (hastayı) 
disclose=açığa vurmak 
disclosure=ifşa 
discourse=söylem 
discretion=ketumiyet 
discrimination=fark gözetme 
dismissal=kovma 
displace=yerinden çıkarmak 
disposal=imha etme 
dispose=atmak 
dispute=çekişmek 
disrupt="kesilmesine yol açmak (toplantının vb) "
disruption=parçalanma 
dissolve=eritmek 
distinction=ayırım 
distinctive=kendine özgü
distort=saptırmak 
distress=üzmek 
disturbing=izaç 
divert=başka yöne çevirmek 
divine=ilahi
doctrine=doktrin 
documentation=dokümantasyon 
domain=ihtisas 
dominance=hakimiyet 
donor=veren kimse 
dose=doz 
drain=tahliye etmek 
drift=şaşırmak 
driving=sürme 
drown=suda boğulmak 
dual=ikili
dub=düzeltmek 
dumb=halter 
duo=eş 
dynamic=hareketli
eager=istekli
earnings=kazanç 
ease=rahatlatmak 
echo=yankılanmak 
ecological=çevre
educator=eğitimci 
effectiveness=etkililik 
efficiency=liyakat 
ego=benlik 
elaborate=ayrıntıyla donatmak 
electoral=seçmenler ile ilgili
elevate=aklı/ruhu geliştirmek 
eligible=hak sahibi 
elite=elit
embark=gemiye bindirmek 
embarrassment=mahcubiyet 
embassy=elçilik 
embed=gömmek 
embody=somutlaştırmak 
emergence=belirme 
empirical=ihtibari
empower=izin vermek 
enact=sahnelemek 
encompass=kuşatmak 
encouragement=teşvik 
encouraging=cesaretlendirici
endeavour=çabalamak 
endless=sonsuz
endorse=arkasına yazmak 
endorsement=ciro 
endure=tahammül etmek 
enforce=zorla yaptırmak 
enforcement=uygulama 
engagement=nişan 
engaging=meşgul etme 
enquire=soru sormak 
enrich=zenginleştirmek 
enrol=kaydolmak 
ensue=meydana gelmek 
enterprise=girişim 
enthusiast=istekli kimse 
entitle=isimlendirmek 
entity=mevcudiyet 
epidemic=salgın 
equality=eşitlik 
equation=denge 
erect=dikmek 
escalate=kızışmak 
essence=öz 
establishment=kuruluş 
eternal=sonsuz 
evacuate=tahliye etmek 
evoke=anımsatmak 
evolutionary=evrimci
exaggerate=abartmak 
excellence=mükemmellik 
exceptional=fevkalade
excess=aşırılık 
exclusion=ret 
exclusive=münhasır
exclusively=özellikle 
execute=infaz etmek 
execution=icra 
exert=sarfetmek (gayret) 
exile=sürgüne göndermek 
expenditure=masraf 
experimental=deneysel
expire=süresi dolmak 
explicit=aşikar
explicitly=açık bir şekilde 
exploitation=kötüye kullanma 
explosive=patlayıcı
extract=özünü çıkarmak 
extremist=ifrata kaçan kimse 
facilitate=hafifletmek 
faction=hizip 
faculty=fakülte 
fade=karartmak 
fairness=insaf 
fatal=ölümcül
fate=kader 
favourable=lehte
feat=beceriklilik 
feeding=besleme 
feminist=kadın hakları savunucusu 
fibre=lif 
fierce=vahşet 
film-maker=filmci 
filter=süzmek 
fine=ceza kesmek 
firearm=ateşli silah 
fit=uymak 
fixture=demirbaş 
flaw=kusur 
flawed=çatlamış
flee=kaçmak 
fleet=filo 
flesh=et 
flexibility=esneklik 
flourish=süslü konuşmak 
fluid=sıvı 
footage=foot hesabıyla ölçü 
foreigner=ecnebi 
forge=demir dövmek 
formula=mama 
formulate=formülleştirmek 
forth=başka 
forthcoming=varış 
foster=bakmak 
fragile=narin
franchise="hükümetçe tanınan ayrıcalık veya bağışıklık "
frankly=açıkça 
frustrated=hakkı yenmiş
frustrating=beyhude 
frustration=hüsran 
functional=pratik
fundraising=para toplama 
funeral=cenaze 
gallon=abd 3,78 litre 
gambling=kumar 
gathering=toplanma 
gaze=gözünü dikmek 
gear=dişli 
generic=üretken
genocide=soykırım 
glance=göz atmak 
glimpse=anlık bakış 
glorious=şanlı
glory=görkem 
governance=kontrol 
grace=lütuf 
grasp=sıkı sıkı tutmak 
grave=kabir 
gravity=yerçekimi 
grid=örgü 
grief=keder 
grin=sırıtmak 
grind=öğütmek 
grip=kavramak 
guerrilla=çeteci 
guidance=yönlendirme 
guilt=suçluluk 
gut=temizlemek 
hail=dolu yağmak 
halfway=yarı yolda 
halt=durmak 
handful=ele avuca sığmayan tip 
handling=idare 
handy=kullanışlı
harassment=taciz 
hardware=donanım 
harmony=ahenk 
harsh=haşin
harvest=hasat 
hatred=nefret 
haunt=sık sık uğramak 
hazard=risk 
heighten=artmak 
heritage=miras 
hierarchy=hiyerarşi 
high-profile=kamuoyunda iyi tanınan
hint=çıtlatmak 
homeland=vatan 
hook=kanca 
hopeful=umutlu
horizon=ufuk 
horn=boynuz 
hostage=rehin 
hostile=hasım 
hostility=düşmanlık 
humanitarian=insancıl kimse 
humanity=insaniyet 
humble=mütevazı
hydrogen=hidrojen 
identification=kimlik saptama 
ideological=ideolojik
ideology=ideoloji 
idiot=salak
ignorance=bilgisizlik 
imagery=imgelem 
immense=harika
imminent=eli kulağında
implementation=uygulama 
imprison=hapse atmak 
imprisonment=hapis 
inability=yetersizlik 
inadequate=yetersiz
inappropriate=uygun olmayan
incidence=rastlantı 
inclined=meyilli
inclusion=derç 
incur=uğramak 
indicator=gösterge 
indictment=itham 
indigenous=yerli
induce=ikna etmek 
indulge=şımartmak 
inequality=eşitsizlik 
infamous=adı kötüye çıkmış
infant=bebek 
infect=bulaştırmak 
inflict=çarptırmak 
influential=etkili
inherent=doğasında var olan
inhibit=engellemek 
initiate=başlatmak 
inject=enjekte etmek 
injection=püskürtme 
injustice=adaletsizlik 
inmate="başkası ile aynı evde oturan kimse "
insertion=derç 
insider=içeriden biri 
inspect=teftiş etmek 
inspection=denetleme 
inspiration=esin 
instinct=içgüdü 
institutional=kuruluşa ait
instruct=haber vermek 
instrumental=enstrümantal
insufficient=kıt
insult=hakaret etmek 
intact=dokunulmamış
intake=alınan miktar 
integral="bir bütünün ayrılmaz bir parçası olan"
integrated=bütünleşmiş
integration=bütünleme 
integrity=tamamlık 
intellectual=düşünsel
intensify=yoğunlaştırmak 
intensity=yoğunluk 
intensive=yoğun
intent=maksat 
interactive=birbirini etkileyen
interface=arayüz 
interfere=müdahale etmek 
interference=karışma 
interim=aralık 
interior=iç
intermediate=orta seviye
intervene=araya girmek 
intervention=araya girme 
intimate=sıkı fıkı
intriguing=entrikacı 
investigator=müfettiş 
invisible=görünmez
invoke=yardım istemek 
involvement=bulaşma 
ironic=alaylı
ironically=işe bakın ki 
irony=hiciv 
irrelevant=konu dışı
isolation=izolasyon 
judicial=yargılayan
junction=birleşme yeri 
jurisdiction=yargı 
just=sadece
justification=gerekçe 
kidnap=(adam/çocuk) kaçırmak 
kidney=böbrek 
kingdom=krallık 
lad=delikanlı 
landlord=ev sahibi 
landmark=sınır işareti 
lap=kucak 
large-scale=büyük
laser=laser ışını 
latter=ikincisi 
lawn=çimenlik 
lawsuit=dava 
layout=düzen 
leak=sızdırmak 
leap=sıçratmak 
legacy=miras 
legendary=efsanevi
legislation=kanunlar 
legislative=yasama
legislature=parlamento 
legitimate=meşrulaştırmak 
lengthy=fazlasıyla uzun
lesbian=lezbiyen
lesser=kiralayan 
lethal=öldürücü
liable=yükümlü
liberal=erkin 
liberation=özgürlük 
liberty=özgürlük 
license=ruhsat 
lifelong=hayat boyu
likelihood=olası olma 
limb=bacak 
linear=doğrusal
line-up=saf 
linger=oyalanmak 
listing=kayıt 
literacy=okuryazarlık 
liver=karaciğer 
lobby=kulis 
log=tomruk 
logic=mantık 
long-standing=epeydir devam eden
loom=dokuma tezgahı 
loop=döngü 
loyalty=sadakat 
machinery=makineler 
magical=büyülü
magistrate=sulh hakimi 
magnetic=çekici
magnitude=büyüklük 
mainland=ana kara 
mainstream=yaygın hale getirmek 
maintenance=bakım 
major=asıl
mandate=manda altına almak 
mandatory=zorunlu
manifest=açıkça göstermek 
manipulate=hareket ettirmek 
manipulation=idare 
manuscript=müsvedde 
march=yürüyüş yapmak (topluca) 
marginal=marjinal
marine=deniz askeri 
marketplace=pazar yeri 
mask=maskelemek 
massacre=katliam 
mathematical=matematiksel
mature=olgun
maximize=yükseltmek 
meaningful=manidar
meantime=ara 
medieval=ortaçağ 
meditation=meditasyon 
melody=melodi 
memo=bildiri 
memoir=inceleme yazısı 
memorial=muhtıra 
mentor=akıl hocalığı yapmak 
merchant=tüccar 
mercy=af 
mere=bataklık 
merely=yalnızca 
merge=birleşmek 
merger=birleşme 
merit=fazilet 
methodology=yöntem bilim 
midst=orta yer 
migration=göç 
militant=militan 
militia=milis 
mill=değirmen 
minimal=asgari
minimize=küçültmek 
mining=maden kazma 
ministry=bakanlık 
minute=dakika 
miracle=mucize 
misery=sefalet 
misleading=yanıltıcı
missile=kurşun 
mob=toplanmak 
mobility=hareketlilik 
mobilize=silah altına almak 
moderate=ılıman
modification=küçük değişiklik 
momentum=hız 
monk=keşiş 
monopoly=tekel 
morality=ahlaklılık 
motive=güdü 
motorist=şoför 
municipal=belediyeye ait
mutual=ortak
namely=olarak adlandırılan 
nationwide=bütün millete ait
naval=denizcilik 
neglect=ihmal etmek 
neighbouring=mücavir
nest=yuva 
net=şebeke 
newsletter=haber bülteni 
niche=oyuğa koymak 
noble=soylu
nod=seçilmek 
nominate=görevlendirmek 
nomination=aday gösterme 
nominee=namzet 
nonetheless=bununla beraber 
non-profit=kar etmeyen
nonsense=safsata 
noon=öğle 
notable=göze çarpan
notably=açıkça 
notify=bildirmek 
notorious=adı çıkmış
novel=roman 
nursery=çocuk odası 
objection=mahzur 
oblige=zorunda bırakmak 
obsess=saplantı haline gelmek 
obsession=takıntı 
occasional=ara sıra olan
occurrence=bulunma 
odds=ihtimal 
offering="ayin sırasında cemaatten
toplanan para "
offspring=yavru 
operational=çalıştırma
opt=karar kılmak 
optical=göz
optimism=iyimserlik 
oral=sözlü
organizational=organizasyonel
orientation=intibak 
originate=kaynaklanmak 
outbreak=salgın 
outing=tur 
outlet=çıkım 
outlook=görünüm 
outrage=zedelemek (gurur) 
outsider=dışarıdaki 
overlook=sarfınazar etmek 
overly=fazlaca 
oversee=oversaw - overseen 
overturn=devrilmek 
overwhelm=boğmak 
overwhelming=ezici
pad="yumuşak bir maddeden yapılmış
koruyucu şey "
parameter=sınırölçüleri 
parental=ebeveyne ait
parish=papazın dini bölgesi 
parliamentary=meclis
partial=taraflı
partially=kısmen 
passing=geçiş 
passive=pasif
pastor=papaz 
patch=yama 
patent=patentini almak 
pathway=yaya geçidi 
patrol=devriye 
patron=korumak 
peak=doruğa ulaşmak 
peasant=köylü 
peculiar=özel eşya 
persist=üstelemek 
persistent=ısrar eden
personnel=eleman 
petition=dilekçe 
philosopher=filozof 
philosophical=felsefi
physician=tıp adamı 
pioneer=öncü 
pipeline=boru hattı 
pirate=korsan
pit=çukur 
plea=savunma 
plead=savunma yapmak 
pledge=rehin 
plug=fiş 
plunge=dalma 
pole=direk 
poll=kesmek 
pond=gölcük 
pop=patlatmak 
portfolio=portföy 
portray=rolünü oynamak 
postpone=ertelemek 
post-war=savaş sonrası
practitioner=uygulayan kimse 
preach=vaaz etmek 
precedent=teamül 
precision=kesinlik 
predator=yırtıcı hayvan 
predecessor=aileden gelen 
predominantly=çoğu 
pregnancy=hamilelik 
prejudice=önyargı 
preliminary=ilk
premier="sınıf veya önem bakımından ilk
sırada "
premise=öncül 
premium=ikramiye 
prescribe=reçete yazmak 
prescription=reçete 
presently=şimdi 
preservation=koruma 
preside=başkanlık yapmak 
presidency=başkanlık 
presidential=başkanlık
prestigious=saygın
presumably=galiba 
presume=farzetmek 
prevail=galebe çalmak 
prevalence=yaygınlık 
prevention=menetme 
prey=soymak 
principal=okul müdürü 
privatization=özelleştirme 
privilege=imtiyaz 
probe=soru sorarak sondaj yapmak 
problematic=problematik
proceeding=konferans 
proceeds=verim 
processing=proses 
processor=işlemci 
proclaim=açığa vurmak 
productive=üretken
productivity=verimlilik 
profitable=kazançlı
profound=engin
projection=projeksiyon 
prominent=öne çıkan
pronounced=aşikar
propaganda=propaganda 
proposition=teklif etmek 
prosecute=takip etmek 
prosecution=devam 
prosecutor=savcı 
prospective=prospektif
prosperity=refah 
protective=koruyucu
protocol=protokol 
province=vilayet 
provincial=dini idarenin yöneticisi 
provision=karşılık 
provoke=kışkırtmak 
psychiatric=psikiyatrik
pulse=nabız 
pump=pompa 
punch=yumruklamak 
query=sorgulamak 
quest=aramak 
quota=pay 
radar=radar 
radical=radikal 
rage=kudurmak 
raid=baskın yapmak 
rally=toplanmak 
ranking=tasnif 
ratio=oran 
rational=rasyonel
ray=ışın 
readily=kolaylıkla 
realization=kavrama 
realm=krallık 
rear=art 
reasoning=muhakeme 
reassure=yeniden güven vermek 
rebel=ayaklanmak 
rebellion=başkaldırı 
recipient=alıcı 
reconstruction=yeniden yapılanma 
recount=yeniden saymak 
referendum=halk oylaması 
reflection=yansıma 
reform=reform yapmak 
refuge=refüj 
refusal=geri çevirme 
regain=geri kazanmak 
regardless=ne olursa olsun 
regime=yönetim şekli 
regulator=regülatör 
regulatory=düzenleyici
rehabilitation=rehabilitasyon 
reign=hüküm sürmek 
rejection=reddetme 
relevance=ilgi 
reliability=güvenilirlik 
reluctant=gönülsüz
remainder=geri kalan 
remains=kalıntılar 
remedy=deva 
reminder=andaç 
removal=sökme 
render=resmetmek 
renew=yenilemek 
renowned=ünlü
rental=kiralık
replacement=yenisiyle değiştirme 
reportedly=söylentilere bakılırsa 
representation=temsil 
reproduce=yeniden üretmek 
reproduction=üreme 
republic=cumhuriyet 
resemble=benzemek 
reside=ikamet etmek 
residence=mesken 
residential=oturmaya elverişli
residue=tortu 
resignation=istifa 
resistance=rezistans 
respective=şahsi
respectively=sırasıyla 
restoration=restore etme 
restraint=kısıtlama 
resume=sürdürmek 
retreat=geri çekilmek 
retrieve=geri almak 
revelation=vahiy 
revenge=intikam almak 
reverse=ters
revival=canlanma 
revive=canlandırmak 
revolutionary=inkılapçı 
rhetoric=güzel konuşma 
rifle=tüfek 
riot=isyan etmek 
rip=sökmek 
ritual=dini tören 
robust=güçlü
rock=sallanmak 
rod=çubuk 
rotate=dönmek 
rotation=dönüş 
ruling=çizgi (cetvelle) 
rumour=söylenti 
sack=çuvala doldurmak 
sacred=kutsal
sacrifice=kurban etmek 
saint=aziz 
sake=hatır 
sanction=yaptırım 
say=söylemek 
scattered=dağınık
sceptical=kuşkucu
scope=faaliyet alanı 
screw=vidalamak 
scrutiny=inceleme 
seal=mühürlemek 
secular=laik
seemingly=sureta 
segment=kesimlemek 
seize=el koymak 
seldom=nadiren 
selective=seçici
senator=senatör 
sensation=sansasyon 
sensitivity=hassaslık 
sentiment=düşünce 
separation=ayırma 
serial=seri 
settlement=yerleşim 
set-up=proje 
shareholder=hissedar 
shatter=kırmak 
shed=dökmek (gözyaşı vb) 
sheer=düpedüz 
shipping=nakliye 
shoot=film çekmek 
shrink=küçültmek 
shrug=omuz silkmek 
sigh=iç çekme 
simulate=taklidini yapmak 
simulation=sahte tavır 
simultaneously=eş zamanlı 
sin=günah 
situated=konum
sketch=taslağını yapmak 
skip="(bir konudan diğerine) atlamak"
slam=ağır bir şekilde eleştirmek 
slap=tokatlamak 
slash=azarlamak 
slavery=kölelik 
slot=yarık 
smash=paramparça etmek 
snap=patlamak 
soak=sırılsıklam etmek 
soar=yüksekten uçmak 
socialist=toplumcu 
sole=ayak tabanı 
solely=sadece 
solicitor=avukat 
solidarity=dayanışma 
solo=solo yapmak 
sound=ses 
sovereignty=egemenlik 
span=karış 
spare=kıymamak 
spark=kıvılcım saçmak 
specialized=uzmanlaşmış
specification=belirtme 
specimen=örnek 
spectacle=görülecek şey 
spectrum=tayf 
spell=hecelemek 
sphere=küre 
spin=döndürmek 
spine=omurga 
spotlight=ilgi çekmek 
spouse=eş 
spy=casus 
squad=ekip 
squeeze=sıkışmak 
stab=saplamak 
stability=kararlılık 
stabilize=dengede tutmak 
stake=kazık 
standing=ayakta
stark=sert
statistical=istatistiksel
steer=yönlendirmek 
stem=-den gelmek 
stereotype=basmakalıp inanış 
stimulus=uyandırıcı 
stir=karıştırmak 
storage=biriktirme 
straightforward=onat
strain=gerilerek zorlanmak (kaslar) 
strand=bükmek (ip) 
strategic=stratejik
striking=çarpıcı
strip=soymak 
strive=uğraşmak 
structural=yapısal
stumble=sendelemek 
stun=şok etkisi yaratmak (birinde) 
submission=arz 
subscriber=abone 
subscription=abonelik 
subsidy="bir kimse veya kuruma ayrılan
meblağ "
substantial=varlıklı
substantially=önemli miktarda 
substitute=yerine geçirmek 
substitution=ikame 
subtle=hemen göze çarpmayan
suburban="şehrin çevresindeki yerleşim alanları "
succession=birbirini izleme 
successive=ardışık
successor=varis 
suck=emmek 
sue=dava açmak 
suicide=intihar 
suite=takım 
summit=zirve 
superb=harikulade
superior=amir 
supervise="gözetip denetleyerek yönetmek"
supervision=teftiş 
supervisor=denetmen 
supplement=ek 
supportive=destek verici
supposedly=sözümona 
suppress=bastırmak 
supreme=yüce
surge=kabarmak (deniz) 
surgical=cerrahi
surplus=fazla 
surrender=vazgeçmek 
surveillance=gözetleme 
suspension=askıya alma 
suspicion=kuşku 
suspicious=kuşkulu
sustain=güç vermek 
swing=sallanmak 
sword=kılıç 
symbolic=sembolik
syndrome=belirgi 
synthesis=bireşim 
systematic=sistematik
tackle=ele almak (bir problemi) 
tactic=taktik 
tactical=ustaca planlanmış
taxpayer=vergi veren kimse 
tempt=kışkırtmak 
tenant=kiracı 
tender=sunmak 
tenure=kadrolu olmak 
terminal=terminal 
terminate=son vermek 
terrain=arazi 
terrific=müthiş
testify=tanıklık etmek 
testimony=şahadet 
texture=özellik 
thankfully=minnettar bir şekilde 
theatrical=tiyatroya ait
theology=teoloji 
theoretical=teorik
thereafter=sonra 
thereby=öylelikle 
thoughtful=düşünceli
thought-provoking=kışkırtıcı
thread=iplik 
threshold=eşik 
thrilled=heyecanlanmış
thrive="thrived/throve - thrived/thriven"
tide=akıntı ile yüzmek 
tighten=sıkmak 
timber=kalas 
timely=zamanında yapılan
tobacco=tütün 
tolerance=müsamaha 
tolerate=tahammül etmek 
toll=çan çalmak 
top=tepe 
torture=eziyet 
toss=tartışmak 
total=toplam 
toxic=zehirli
trace=iz sürmek 
trademark=marka 
trail=iz 
trailer=treyler 
transaction=işlem 
transcript=belge 
transformation=dönüşüm 
transit=geçmek 
transmission=şanzıman 
transparency=şeffaflık 
transparent=saydam
trauma=travma 
treaty=antlaşma 
tremendous=mahşeri
tribal=kabileye ait
tribunal=yargıç kürsüsü 
tribute=haraç 
trigger=tetiklemek 
trio=üçlü takım 
triumph=zafer 
trophy=hayvan başları ile süslemek 
troubled=sıkıntılı
trustee=yediemin 
tuition=okul ücreti 
turnout=toplantı mevcudu 
turnover=ciro 
twist=bükülmek 
undergraduate=lisans
underlying=altında yatan
undermine=baltalamak 
undoubtedly=şüphesiz olarak 
unify=aynı yapmak 
unprecedented=eşi benzeri görülmemiş
unveil=örtüsünü kaldırmak 
upcoming=olmak üzere olan
upgrade=bir üst modele geçmek 
uphold=upheld - upheld 
utility=yardımcı yazılım 
utilize=faydalı hale getirmek 
utterly=tümüyle 
vacuum=vakum 
vague=şüpheli
validity=geçerlilik 
vanish=ortadan kaybolmak 
variable=değişken
varied=değişik
vein=damar 
venture=girişim 
verbal=sözlü
verdict=hüküm 
verify=doğrulamak 
verse=dize 
versus=karşı 
vessel=gemi 
veteran=eski kurt
viable=yaşayabilir
vibrant=titreşimli
vice=mengene 
vicious=kirli
villager=köylü 
violate=ihlal etmek 
violation=ihlal 
virtue=fazilet 
vocal=sesli
vow=yemin etmek 
vulnerability=hasar görebilirlik 
vulnerable=zedelenebilir
ward=vesayet 
warehouse=ardiye 
warfare=savaş 
warrant=garanti etmek 
warrior=savaşçı 
weaken=güçsüzleştirmek 
weave=dokumak 
weed=ot 
well=fışkırmak 
well-being=hayır 
whatsoever=hangi
whereby=vasıtasıyla [bağ.]
whip=kamçılamak 
wholly=büsbütün 
widen=genişletmek 
widow=dul bırakmak 
width=en 
willingness=gönüllülük 
wipe=silmek 
wit=zeka kıvraklığı 
withdrawal=bırakma 
workout=çalışarak elde etmek 
worship=tapmak 
worthwhile=değer
worthy=önemli kimse 
yell=bağırmak 
yield=teslim olmak 
youngster=çocuk 
